<l class="III" p3p="bajkaXXX" pos="v">bajkedh</l>	bajkedh+V+Ind+Prs+Sg3	bajkoe
<l class="III" p3p="barhkaXXX" pos="v">barhkedh</l>	barhkedh+V+Ind+Prs+Sg3	barhkoe
<l class="I" p3p="bihkieXXX" pos="v">bihkedh</l>	bihkedh+V+Ind+Prs+Sg3	bæhka
<l p3p="budtie/bådtaXXX" pos="v">budtedh</l>	budtedh+V+Ind+Prs+Sg3	budtie	budtedh+V+Ind+Prs+Sg3	bådta
<l class="I" p3p="buvvieXXX" pos="v">buvvedh</l>	buvvedh+V+Ind+Prs+Sg3	båvva
<l class="V" p3p="bårrestahtaXXX" pos="v">bårrestohtedh</l>	bårrestohtedh+V+Ind+Prs+Sg3	bårrestohtoe
<l class="IV" p3p="dalhkoeXXX" pos="v">dalhkedh</l>	dalhkedh+V+Ind+Prs+Sg3	dalhka
<l class="III" p3p="XXX" pos="v">darhkedh</l>	darhkedh+V+Ind+Prs+Sg3	darhkoe	darhkedh+V+Ind+Prs+Sg3	darhka
<l class="IV" p3p="dovvedeXXX" pos="v">dovvesovvedh</l>	dovvesovvedh+V+Ind+Prs+Sg3	dovvesåvva
<l class="V" p3p="dååjreXXX" pos="v">dååjredh</l>	dååjredh+V+Ind+Prs+Sg3	dååjroe
<l class="IV" p3p="dijmieXXX" pos="v">dïjmedh</l>	dïjmedh+V+Ind+Prs+Sg3	dæjma
<l class="VI" p3p="dæjpaXXX" pos="v">dïjpedh</l>	dïjpedh+V+Ind+Prs+Sg3	dæjpa
<l class="IV" p3p="XXX" pos="v">gaatelassjedh</l>	gaatelassjedh+V+Ind+Prs+Sg3	gaatelassjoe
<l class="VI" p3p="gadtjaXXX" pos="v">gadtjedh</l>	gadtjedh+V+Ind+Prs+Sg3	gadtja
<l class="III" p3p="galhkaXXX" pos="v">galhkedh</l>	galhkedh+V+Ind+Prs+Sg3	galhkoe
<l class="VI" p3p="XXX" pos="v">girmedh</l>	girmedh+V+Ind+Prs+Sg3	gærma
<l class="IV" p3p="gåvla/govloeXXX" pos="v">govledh</l>	govledh+V+Ind+Prs+Sg3	govloe	govledh+V+Ind+Prs+Sg3	gåvla
<l class="I" p3p="guhtsieXXX" pos="v">guhtsedh</l>	guhtsedh+V+Ind+Prs+Sg3	gåhtsa
<l class="III" p3p="jamhkaXXX" pos="v">jamhkedh</l>	jamhkedh+V+Ind+Prs+Sg3	jamhkoe
<l class="VI" p3p="XXX" pos="v">njoetsedh</l>	njoetsedh+V+Ind+Prs+Sg3	njuatsa
<l class="VI" p3p="nåktaXXX" pos="v">nuktedh</l>	nuktedh+V+Ind+Prs+Sg3	nuktie
<l class="VI" p3p="XXX" pos="v">nïekedh</l>	nïekedh+V+Ind+Prs+Sg3	neaka
<l class="IV" p3p="nearhkaXXX" pos="v">nïetkedh</l>	nïetkedh+V+Ind+Prs+Sg3	neatka
<l class="IV" p3p="pråvhkaXXX" pos="v">provhkedh</l>	provhkedh+V+Ind+Prs+Sg3	provhkoe	provhkedh+V+Ind+Prs+Sg3	pråvhka
<l class="VI" p3p="XXX" pos="v">skuvledh</l>	skuvledh+V+Ind+Prs+Sg3	skuvla
<l minip="notSg1" p3p="svæjra/svijrieXXX" pos="v">svijredh</l>	svijredh+V+Ind+Prs+Sg3	svijrie	svijredh+V+Ind+Prs+Sg3	svæjra
<l class="V" p3p="syjhtieXXX" pos="v">syjhtedh</l>	syjhtedh+V+Ind+Prs+Sg3	syjhta
<l class="IV" p3p="XXX" pos="v">tjalkedh</l>	tjalkedh+V+Ind+Prs+Sg3	tjalkoe	tjalkedh+V+Ind+Prs+Sg3	tjalka
<l p3p="tjihtie/tjæhtaXXX" pos="v">tjihtedh</l>	tjihtedh+V+Ind+Prs+Sg3	tjihtie	tjihtedh+V+Ind+Prs+Sg3	tjæhta
<l class="VI" p3p="tjærraXXX" pos="v">tjïrredh</l>	tjïrredh+V+Ind+Prs+Sg3	tjærra
<l p3p="tseegkieXXX" pos="v">tsegkedh</l>	tsegkedh+V+Ind+Prs+Sg3	tsagka
<l class="VI" p3p="væssjaXXX" pos="v">vïssjedh</l>	vïssjedh+V+Ind+Prs+Sg3	væssja
<l class="VI" p3p="XXX" pos="v">öörnedh</l>	öörnedh+V+Ind+Prs+Sg3	öörna
