vuastavoejesnaejrie	ostesmørbrød
jorpegaahkotje	bolle	x
gaavnjeresgaahkoe	rundstykke	x
jissehtslaejpie	flatbrød
tsåalhkelaejpie	pikkebrød x
møøvkeslaejpie	pikkebrød	x
sijlelaejpie	glokake
ruevtienlaejpie	hyllkake
gierkienlaejpie	hyllkake
måasasgaahkoe	bløtkake	x
sjolovlaadegaahkoe	sjokoladekake	x
viskesroehtsegaahkoe	gulrotkake
eeplagaahkoe	eplekake	x
baananegaahkoe	banankake	x
maasipanegaahkoe	marsipankake	x
vuastagaahkoe	ostekake
muerjiegaahkoe	fruktkake
tjastegaahkoe	iskake
vuastasnaejrie	hvitostskive
bïssememunnie	speilegg
seervelaate	servelat	x
saalami	salami	x
skompe	kjøttrull	x
nuvgadti	nugatti	x
gerniebliehkie	cornflakes
håannegegernieh	honnikorn
haegriepleetgh	havremi	x
sylhta	syltetøy	x
tsiehtsmuerjie	bringebær	x
jåartemuerjie	jordbær	x
biejjienmuerjie	solbær
libriepoeste	leverpostei	x
prijme	prim	x
maajonese	majones	x
tovmaate	tomat	x
aagurke	agurk	x
paaprika	paprika	x
bruvse	brus
juvse	juice
kaakaove	kakao	x
ingefærenvoelege	ingefærøl	x
gaskebiejjiengoerve	middagspølse
bearkoegaahkoe	kjøttkake
bearkoestongke	kjøttpudding	x
bearkoedajje	kjøttfarse	x
meelemebearkoeh	malt kjøtt, kjøttdeig
bijremebearkoe	skavet kjøtt
bïssemebearkoe	stekt kjøtt
soevesbearkoe	røykakjøtt
liemie	kjøttkraft	x
kådteledte	kotelett	x
måaroebearkoe	kjøttbein	x	
snurkeniehterdahke	ribbe
soenåedtjie	x
lapskause	lapskaus	x
kraavtse	grøt	x
haegriekrovnekraavtse	havregrøt	x
rijsenkrovnekraavtse	risengrynsgrøt	x
krovnejavvoehkraavtse	grynmelsgrøt	x
såvroegihpekraavtse	rømmegrøt	x
kaalkuvne	kalkun	x
vöönhtsentjovke	kylling
taakoe	taco	x
pizza	pizza	x
paannelaejpie	pannekake
earhtenhjoptse	ertesuppe	x

muerjiejoptse
kroenesaatenjoptse
gueliejoptse
mearoenguelie
soevesguelie
gejhkieguelie
gueliegaahkoe
gueliegaamsoe
dååpmehke
loese
sijhke
haerrie
sælta
suvriessælta
saejtie
rööpsesbliehkie
blihkieguelie
raavre
uvrie
doerske
gueliepænna
lovhteguelie
guelienlibre
mietemh




