aarebistie	aarebistie	+?
aarhtsetjelmie	aarhtsetjelmie	+?
aerebi	aerebi	+?
aeveren	aeveren	+?
alfabeete	alfabeete	+?
almetjeplïere	almetjeplïere	+?
baetjh	baetjh	+?
beapmoelihtie	beapmoelihtie	+?
bearkanidh	bearkanidh	+?
beetnehlihtie	beetnehlihtie	+?
bejhkebarkoe	bejhkebarkoe	+?
bejhkegåetie	bejhkegåetie	+?
bieljieværjoe	bieljieværjoe	+?
bietsiesååle	bietsiesååle	+?
bigkemedïrrege	bigkemedïrrege	+?
bigkemesijjie	bigkemesijjie	+?
bussevuejije	bussevuejije	+?
byöpmedistedh	byöpmedistedh	+?
båaskoej	båaskoej	+?
båerieslaaketje	båerieslaaketje	+?
båeriesskodtje	båeriesskodtje	+?
bïevstere	bïevstere	+?
daara	daara	+?
daarah	daarah	+?
daektie	daektie	+?
daelviesåekie	daelviesåekie	+?
dealoeldihkie	dealoeldihkie	+?
diedtielidh	diedtielidh	+?
dohkh	dohkh	+?
domtoes	domtoes	+?
dovnesh	dovnesh	+?
dæjpeladtje	dæjpeladtje	+?
eatnemefaage	eatnemefaage	+?
eensilaake	eensilaake	+?
engelsktæjmoe	engelsktæjmoe	+?
faahketje	faahketje	+?
feerje	feerje	+?
fievsiegåetie	fievsiegåetie	+?
fragke	fragke	+?
gahtjestahke	gahtjestahke	+?
gavhtoeh	gavhtoeh	+?
geajnoebealesne	geajnoebealesne	+?
geatskamisnie	geatskamisnie	+?
geehpedh	geehpedh	+?
geervealmetje	geervealmetje	+?
gejhkieloese	gejhkieloese	+?
giebrese	giebrese	+?
giesiefievsie	giesiefievsie	+?
gietskiebasse	gietskiebasse	+?
goerkese	goerkese	+?
gohpege	gohpege	+?
golmeluhkie	golmeluhkie	+?
gosk	gosk	+?
gujne	gujne	+?
gullievoelpetje	gullievoelpetje	+?
gåabpegh	gåabpegh	+?
gåvloes	gåvloes	+?
gællan	gællan	+?
gærjahælloe	gærjahælloe	+?
gïebreldahke	gïebreldahke	+?
haajh	haajh	+?
haarmoes	haarmoes	+?
haebjie	haebjie	+?
heevehtimmiebiejjie	heevehtimmiebiejjie	+?
hepsie	hepsie	+?
hijvene	hijvene	+?
iemeds	iemeds	+?
jabjah	jabjah	+?
jabjoeh	jabjoeh	+?
jabjoehkaarre	jabjoehkaarre	+?
jabjohke	jabjohke	+?
jaksoesmierie	jaksoesmierie	+?
jarkan	jarkan	+?
jeatjhlaakan	jeatjhlaakan	+?
jeehtieh	jeehtieh	+?
jåartanåelie	jåartanåelie	+?
jåhteje	jåhteje	+?
jåktjhiehkeden	jåktjhiehkeden	+?
jöödtedh	jöödtedh	+?
klaaseraedtie	klaaseraedtie	+?
klåtnjodh	klåtnjodh	+?
kristietnie	kristietnie	+?
laavvardahke	laavvardahke	+?
leekedimmiebïenghke	leekedimmiebïenghke	+?
leekemegåetie	leekemegåetie	+?
långkh	långkh	+?
læjnoes	læjnoes	+?
løssh	løssh	+?
maadterhaahka	maadterhaahka	+?
minngiesijjie	minngiesijjie	+?
moeveles	moeveles	+?
måaresne	måaresne	+?
målsohth	målsohth	+?
njammestidh	njammestidh	+?
njavloeh	njavloeh	+?
noerhtesaelhtie	noerhtesaelhtie	+?
nujkiestidh	nujkiestidh	+?
nukte	nukte	+?
nållaskovvedh	nållaskovvedh	+?
nïekedasse	nïekedasse	+?
ovlæhkoe	ovlæhkoe	+?
ovmurries	ovmurries	+?
ovmurries	ovmurries	+?
ovraeffie	ovraeffie	+?
praaretji	praaretji	+?
pruvhkedh	pruvhkedh	+?
reakedsheevehtimmie	reakedsheevehtimmie	+?
reakedsvadtese	reakedsvadtese	+?
restaurante	restaurante	+?
robovte	robovte	+?
romaane	romaane	+?
rovnekåbpoe	rovnekåbpoe	+?
ruevtiestaavra	ruevtiestaavra	+?
saajvenïejte	saajvenïejte	+?
saajveveartene	saajveveartene	+?
saajveniejtenïejte	saajveniejtenïejte	+?
saelhtiensaemie	saelhtiensaemie	+?
seangkoegietjie	seangkoegietjie	+?
seareme	seareme	+?
sjalloeh	sjalloeh	+?
skuvletuvre	skuvletuvre	+?
skåartoe	skåartoe	+?
smaavesaejrie	smaavesaejrie	+?
smaejlies	smaejlies	+?
sneehpesgeajnoe	sneehpesgeajnoe	+?
snjearatjelmiegujmie	snjearatjelmiegujmie	+?
stadtjoe	stadtjoe	+?
steinbijte	steinbijte	+?
stråamhpoe	stråamhpoe	+?
sygkele	sygkele	+?
sårkoes	sårkoes	+?
sööjmehtje	sööjmehtje	+?
tjaetsiestratjke	tjaetsiestratjke	+?
tjerkebi	tjerkebi	+?
tjoevehke	tjoevehke	+?
tjöötje	tjöötje	+?
trajlere	trajlere	+?
trööredh	trööredh	+?
tsaepmiestidh	tsaepmiestidh	+?
vaahreles	vaahreles	+?
vaane	vaane	+?
vaepiedodtje	vaepiedodtje	+?
vajmedh	vajmedh	+?
vampyjre	vampyjre	+?
vealtjarim	vealtjarim	+?
vealtjeri	vealtjeri	+?
vearsoes	vearsoes	+?
vellie	vellie	+?
vienth	vienth	+?
vihteles	vihteles	+?
vijremesijjie	vijremesijjie	+?
virtiehtidh	virtiehtidh	+?
voejemegåetie	voejemegåetie	+?
voj	voj	+?
vuasehks	vuasehks	+?
væjmodh	væjmodh	+?
vöövnjelihks	vöövnjelihks	+?
åedtjiebearkoe	åedtjiebearkoe	+?
åejviealmetje	åejviealmetje	+?
ålkine	ålkine	+?
