soejedh	soejedh+V+IV+Inf
gajjedh	gajjedh+V+IV+Inf
låånjedh	låånjedh+V+IV+Inf
lagkedh	lagkedh+V+IV+Inf
slihkedh	slihkedh+V+IV+Inf
skeajkedh	skeajkedh+V+IV+Inf
gïejkedh	gïejkedh+V+IV+Inf
smualkedh	smualkedh+V+IV+Inf
jolkedh	jolkedh+V+IV+Inf
soemkedh	soemkedh+V+IV+Inf
luemkedh	luemkedh+V+IV+Inf
njurkedh	njurkedh+V+IV+Inf
mannadalledh	mannadalledh+V+IV+Inf
lïjmedalledh	lïjmedalledh+V+IV+Inf
vïtnedalledh	vïtnedalledh+V+IV+Inf
tjeahpastalledh	tjeahpastalledh+V+IV+Inf
njylledh	njylledh+V+IV+Inf
vajmedh	vajmedh+V+IV+Inf
loejmedh	loejmedh+V+IV+Inf
skööpmedh	skööpmedh+V+IV+Inf
mosnedh	mosnedh+V+IV+Inf
staarpedh	staarpedh+V+IV+Inf
kleeredh	kleeredh+V+IV+Inf
maagredh	maagredh+V+IV+Inf
knïrredh	knïrredh+V+IV+Inf
maatsedh	maatsedh+V+IV+Inf
snovsedh	snovsedh+V+IV+Inf
tjåanghkenadtedh	tjåanghkenadtedh+V+IV+Inf
tsoepkenadtedh	tsoepkenadtedh+V+IV+Inf
doeltedh	doeltedh+V+IV+Inf
jåvkelistedh	jåvkelistedh+V+IV+Inf
jarrelostedh	jarrelostedh+V+IV+Inf
jårrelostedh	jårrelostedh+V+IV+Inf
jammarostedh	jammarostedh+V+IV+Inf
stïsserostedh	stïsserostedh+V+IV+Inf
aalhterostedh	aalhterostedh+V+IV+Inf
vïssjehtoevedh	vïssjehtoevedh+V+IV+Inf
tjaarhvedh	tjaarhvedh+V+IV+Inf
lavvedh	lavvedh+V+IV+Inf
ååjmehtovvedh	ååjmehtovvedh+V+IV+Inf
voevnehtovvedh	voevnehtovvedh+V+IV+Inf
bïjvestovvedh	bïjvestovvedh+V+IV+Inf
njuvvedh	njuvvedh+V+IV+Inf
nuvvedh	nuvvedh+V+IV+Inf
låvvedh	låvvedh+V+IV+Inf
såhkadidh	såhkadidh+V+IV+Inf
skælladidh	skælladidh+V+IV+Inf
krokngedidh	krokngedidh+V+IV+Inf
klevjiedidh	klevjiedidh+V+IV+Inf
musniedidh	musniedidh+V+IV+Inf
hepsiedidh	hepsiedidh+V+IV+Inf
moenjedidh	moenjedidh+V+IV+Inf
gotnjedidh	gotnjedidh+V+IV+Inf
tjoekedidh	tjoekedidh+V+IV+Inf
gïekedidh	gïekedidh+V+IV+Inf
njïehkedidh	njïehkedidh+V+IV+Inf
kruvhkedidh	kruvhkedidh+V+IV+Inf
njïejkedidh	njïejkedidh+V+IV+Inf
snoelkedidh	snoelkedidh+V+IV+Inf
lïjmedidh	lïjmedidh+V+IV+Inf
vïesedidh	vïesedidh+V+IV+Inf
loejhtedidh	loejhtedidh+V+IV+Inf
lyvvedidh	lyvvedidh+V+IV+Inf
madtjeldidh	madtjeldidh+V+IV+Inf
goegkeldidh	goegkeldidh+V+IV+Inf
gampeldidh	gampeldidh+V+IV+Inf
gaelvierdidh	gaelvierdidh+V+IV+Inf
njievkerdidh	njievkerdidh+V+IV+Inf
njïevkerdidh	njïevkerdidh+V+IV+Inf
gåpmerdidh	gåpmerdidh+V+IV+Inf
funterdidh	funterdidh+V+IV+Inf
goeverdidh	goeverdidh+V+IV+Inf
kråabjegidh	kråabjegidh+V+IV+Inf
syjhtjegidh	syjhtjegidh+V+IV+Inf
sïjhtjegidh	sïjhtjegidh+V+IV+Inf
loebpegidh	loebpegidh+V+IV+Inf
gabregidh	gabregidh+V+IV+Inf
tsiptsegidh	tsiptsegidh+V+IV+Inf
gabpalgidh	gabpalgidh+V+IV+Inf
geasalgidh	geasalgidh+V+IV+Inf
govlelgidh	govlelgidh+V+IV+Inf
gabrelgidh	gabrelgidh+V+IV+Inf
bïjvijidh	bïjvijidh+V+IV+Inf
klavjasjidh	klavjasjidh+V+IV+Inf
gælhkasjidh	gælhkasjidh+V+IV+Inf
gajkasjidh	gajkasjidh+V+IV+Inf
geamhpasjidh	geamhpasjidh+V+IV+Inf
daarhvasjidh	daarhvasjidh+V+IV+Inf
snorhtjesjidh	snorhtjesjidh+V+IV+Inf
njævkesjidh	njævkesjidh+V+IV+Inf
leajpaskidh	leajpaskidh+V+IV+Inf
buelielidh	buelielidh+V+IV+Inf
jåvkelidh	jåvkelidh+V+IV+Inf
slobpelidh	slobpelidh+V+IV+Inf
buaramidh	buaramidh+V+IV+Inf
marhkanidh	marhkanidh+V+IV+Inf
mårhkanidh	mårhkanidh+V+IV+Inf
maaskanidh	maaskanidh+V+IV+Inf
båtnanidh	båtnanidh+V+IV+Inf
aajpanidh	aajpanidh+V+IV+Inf
barranidh	barranidh+V+IV+Inf
rïehkenidh	rïehkenidh+V+IV+Inf
tjïelkenidh	tjïelkenidh+V+IV+Inf
jïepkenidh	jïepkenidh+V+IV+Inf
loebpenidh	loebpenidh+V+IV+Inf
tjååhpenidh	tjååhpenidh+V+IV+Inf
hïerpenidh	hïerpenidh+V+IV+Inf
soersenidh	soersenidh+V+IV+Inf
slijhtenidh	slijhtenidh+V+IV+Inf
baektjieridh	baektjieridh+V+IV+Inf
våatjasidh	våatjasidh+V+IV+Inf
tsagkesidh	tsagkesidh+V+IV+Inf
loegkesidh	loegkesidh+V+IV+Inf
lïegkesidh	lïegkesidh+V+IV+Inf
slogkesidh	slogkesidh+V+IV+Inf
lajkesidh	lajkesidh+V+IV+Inf
jarkesidh	jarkesidh+V+IV+Inf
maaskesidh	maaskesidh+V+IV+Inf
gatskesidh	gatskesidh+V+IV+Inf
strovkesidh	strovkesidh+V+IV+Inf
bæktahtidh	bæktahtidh+V+IV+Inf
gasngehtidh	gasngehtidh+V+IV+Inf
vilnjiehtidh	vilnjiehtidh+V+IV+Inf
gemkiehtidh	gemkiehtidh+V+IV+Inf
gevviehtidh	gevviehtidh+V+IV+Inf
njyjjehtidh	njyjjehtidh+V+IV+Inf
moenjehtidh	moenjehtidh+V+IV+Inf
gasnehtidh	gasnehtidh+V+IV+Inf
vïesehtidh	vïesehtidh+V+IV+Inf
gærrastidh	gærrastidh+V+IV+Inf
baeljiestidh	baeljiestidh+V+IV+Inf
klitnjiestidh	klitnjiestidh+V+IV+Inf
struerkiestidh	struerkiestidh+V+IV+Inf
nïegkestidh	nïegkestidh+V+IV+Inf
gïejkestidh	gïejkestidh+V+IV+Inf
gïjkestidh	gïjkestidh+V+IV+Inf
skööpmestidh	skööpmestidh+V+IV+Inf
leajpoestidh	leajpoestidh+V+IV+Inf
gabrestidh	gabrestidh+V+IV+Inf
ståavestidh	ståavestidh+V+IV+Inf
bïjvestidh	bïjvestidh+V+IV+Inf
væssjodh	væssjodh+V+IV+Inf
njalhtjodh	njalhtjodh+V+IV+Inf
måsnodh	måsnodh+V+IV+Inf
tråabpodh	tråabpodh+V+IV+Inf
goejedh	goejedh+V+TV+Inf
laanjedh	laanjedh+V+TV+Inf
plïjhtjedh	plïjhtjedh+V+TV+Inf
tjibkedh	tjibkedh+V+TV+Inf
tjuegkedh	tjuegkedh+V+TV+Inf
vuarhkedh	vuarhkedh+V+TV+Inf
såarhkedh	såarhkedh+V+TV+Inf
vuerhkedh	vuerhkedh+V+TV+Inf
tjööpkedh	tjööpkedh+V+TV+Inf
geerkedh	geerkedh+V+TV+Inf
gurkedh	gurkedh+V+TV+Inf
spïeledh	spïeledh+V+TV+Inf
njalledh	njalledh+V+TV+Inf
steelledh	steelledh+V+TV+Inf
tjulledh	tjulledh+V+TV+Inf
söövledh	söövledh+V+TV+Inf
mååledh	mååledh+V+TV+Inf
tjoemedh	tjoemedh+V+TV+Inf
liemnedh	liemnedh+V+TV+Inf
tjonnedh	tjonnedh+V+TV+Inf
slovhpedh	slovhpedh+V+TV+Inf
tååhpedh	tååhpedh+V+TV+Inf
beejredh	beejredh+V+TV+Inf
lijredh	lijredh+V+TV+Inf
neerredh	neerredh+V+TV+Inf
salsedh	salsedh+V+TV+Inf
tsabtsedh	tsabtsedh+V+TV+Inf
mudtsedh	mudtsedh+V+TV+Inf
tsamtsedh	tsamtsedh+V+TV+Inf
tjaalehtjadtedh	tjaalehtjadtedh+V+TV+Inf
veahkesadtedh	veahkesadtedh+V+TV+Inf
löödtedh	löödtedh+V+TV+Inf
voejtedh	voejtedh+V+TV+Inf
nööktedh	nööktedh+V+TV+Inf
njiltedh	njiltedh+V+TV+Inf
gïertedh	gïertedh+V+TV+Inf
noljedestedh	noljedestedh+V+TV+Inf
guejstedh	guejstedh+V+TV+Inf
madtjelostedh	madtjelostedh+V+TV+Inf
eevedh	eevedh+V+TV+Inf
kreevedh	kreevedh+V+TV+Inf
soelvedh	soelvedh+V+TV+Inf
tjöörvedh	tjöörvedh+V+TV+Inf
jåaskadidh	jåaskadidh+V+TV+Inf
gåajhtsadidh	gåajhtsadidh+V+TV+Inf
gåaltadidh	gåaltadidh+V+TV+Inf
vievliedidh	vievliedidh+V+TV+Inf
diejviedidh	diejviedidh+V+TV+Inf
jïegkedidh	jïegkedidh+V+TV+Inf
nalhkedidh	nalhkedidh+V+TV+Inf
jilhkedidh	jilhkedidh+V+TV+Inf
tjamkedidh	tjamkedidh+V+TV+Inf
njaalmedidh	njaalmedidh+V+TV+Inf
jåaskoedidh	jåaskoedidh+V+TV+Inf
sohpedidh	sohpedidh+V+TV+Inf
spååredidh	spååredidh+V+TV+Inf
moentedidh	moentedidh+V+TV+Inf
mahtjaldidh	mahtjaldidh+V+TV+Inf
gïemhpeldidh	gïemhpeldidh+V+TV+Inf
vïedteldidh	vïedteldidh+V+TV+Inf
nullierdidh	nullierdidh+V+TV+Inf
mæjjasjidh	mæjjasjidh+V+TV+Inf
vaartasjidh	vaartasjidh+V+TV+Inf
veartasjidh	veartasjidh+V+TV+Inf
nogkesjidh	nogkesjidh+V+TV+Inf
knogkesjidh	knogkesjidh+V+TV+Inf
njïhkesjidh	njïhkesjidh+V+TV+Inf
sïhkesjidh	sïhkesjidh+V+TV+Inf
mahtjalidh	mahtjalidh+V+TV+Inf
gorkelidh	gorkelidh+V+TV+Inf
gajhkoelidh	gajhkoelidh+V+TV+Inf
gåaltoelidh	gåaltoelidh+V+TV+Inf
speerrelidh	speerrelidh+V+TV+Inf
sjalkeridh	sjalkeridh+V+TV+Inf
gosteridh	gosteridh+V+TV+Inf
kramhkesidh	kramhkesidh+V+TV+Inf
gævnjahtidh	gævnjahtidh+V+TV+Inf
barhkahtidh	barhkahtidh+V+TV+Inf
gaarkahtidh	gaarkahtidh+V+TV+Inf
njarkahtidh	njarkahtidh+V+TV+Inf
njåarahtidh	njåarahtidh+V+TV+Inf
marrahtidh	marrahtidh+V+TV+Inf
tjåegkiehtidh	tjåegkiehtidh+V+TV+Inf
tsåetskiehtidh	tsåetskiehtidh+V+TV+Inf
jedtiehtidh	jedtiehtidh+V+TV+Inf
biktiehtidh	biktiehtidh+V+TV+Inf
vaestiehtidh	vaestiehtidh+V+TV+Inf
njovhkehtidh	njovhkehtidh+V+TV+Inf
nåvhkehtidh	nåvhkehtidh+V+TV+Inf
jarkehtidh	jarkehtidh+V+TV+Inf
njarkehtidh	njarkehtidh+V+TV+Inf
jïevkehtidh	jïevkehtidh+V+TV+Inf
kradtjoehtidh	kradtjoehtidh+V+TV+Inf
barhkoehtidh	barhkoehtidh+V+TV+Inf
gåvhkoehtidh	gåvhkoehtidh+V+TV+Inf
læhkoehtidh	læhkoehtidh+V+TV+Inf
garkoehtidh	garkoehtidh+V+TV+Inf
gårkoehtidh	gårkoehtidh+V+TV+Inf
jårkoehtidh	jårkoehtidh+V+TV+Inf
njårkoehtidh	njårkoehtidh+V+TV+Inf
gælpoehtidh	gælpoehtidh+V+TV+Inf
njåaroehtidh	njåaroehtidh+V+TV+Inf
doebpehtidh	doebpehtidh+V+TV+Inf
sleegrehtidh	sleegrehtidh+V+TV+Inf
geerrehtidh	geerrehtidh+V+TV+Inf
neerrehtidh	neerrehtidh+V+TV+Inf
marngastidh	marngastidh+V+TV+Inf
naljastidh	naljastidh+V+TV+Inf
jarkastidh	jarkastidh+V+TV+Inf
buarastidh	buarastidh+V+TV+Inf
libnjiestidh	libnjiestidh+V+TV+Inf
gegkiestidh	gegkiestidh+V+TV+Inf
bihkiestidh	bihkiestidh+V+TV+Inf
aejkiestidh	aejkiestidh+V+TV+Inf
njilliestidh	njilliestidh+V+TV+Inf
gupmiestidh	gupmiestidh+V+TV+Inf
mievriestidh	mievriestidh+V+TV+Inf
noljestidh	noljestidh+V+TV+Inf
nuljestidh	nuljestidh+V+TV+Inf
gotnjestidh	gotnjestidh+V+TV+Inf
sïekestidh	sïekestidh+V+TV+Inf
jarkestidh	jarkestidh+V+TV+Inf
tjonnestidh	tjonnestidh+V+TV+Inf
låånestidh	låånestidh+V+TV+Inf
nåljoestidh	nåljoestidh+V+TV+Inf
gåvnjoestidh	gåvnjoestidh+V+TV+Inf
læhkoestidh	læhkoestidh+V+TV+Inf
aalmoestidh	aalmoestidh+V+TV+Inf
våavtsoestidh	våavtsoestidh+V+TV+Inf
sleebpestidh	sleebpestidh+V+TV+Inf
lijrestidh	lijrestidh+V+TV+Inf
maarhvestidh	maarhvestidh+V+TV+Inf
njeajodh	njeajodh+V+TV+Inf
klåvhnjodh	klåvhnjodh+V+TV+Inf
speadtjodh	speadtjodh+V+TV+Inf
bådtjodh	bådtjodh+V+TV+Inf
tjabkodh	tjabkodh+V+TV+Inf
sagkodh	sagkodh+V+TV+Inf
gajhkodh	gajhkodh+V+TV+Inf
båarhkodh	båarhkodh+V+TV+Inf
tjamkodh	tjamkodh+V+TV+Inf
njårkodh	njårkodh+V+TV+Inf
låaskodh	låaskodh+V+TV+Inf
spealodh	spealodh+V+TV+Inf
låabpodh	låabpodh+V+TV+Inf
nærhtodh	nærhtodh+V+TV+Inf
neavhtodh	neavhtodh+V+TV+Inf
vaastodh	vaastodh+V+TV+Inf
sjåavodh	sjåavodh+V+TV+Inf
maarhvodh	maarhvodh+V+TV+Inf
geerje	geerje+A+Sg+Nom
håakene	håakene+A+Sg+Nom
håakan	håakan+A+Sg+Nom
såafa	såafa+N+Sg+Nom
såanga	såanga+N+Sg+Nom
boeltaajja	boelt#aajja+N+Sg+Nom
vaarja	vaarja+N+Sg+Nom
kraassja	kraassja+N+Sg+Nom
båassja	båassja+N+Sg+Nom
njålhtja	njålhtja+N+Sg+Nom
skælhtja	skælhtja+N+Sg+Nom
eanhtja	eanhtja+N+Sg+Nom
skæltja	skæltja+N+Sg+Nom
seahka	seahka+N+Sg+Nom
lahka	lahka+N+Sg+Nom
klahka	klahka+N+Sg+Nom
moeretjåalhka	moere#tjåalhka+N+Sg+Nom
hearhka	hearhka+N+Sg+Nom
gærhka	gærhka+N+Sg+Nom
læhka	læhka+N+Sg+Nom
baajka	baajka+N+Sg+Nom
næjka	næjka+N+Sg+Nom
faarka	faarka+N+Sg+Nom
bearka	bearka+N+Sg+Nom
snarka	snarka+N+Sg+Nom
snårka	snårka+N+Sg+Nom
batska	batska+N+Sg+Nom
naala	naala+N+Sg+Nom
svaala	svaala+N+Sg+Nom
deala	deala+N+Sg+Nom
buala	buala+N+Sg+Nom
daabla	daabla+N+Sg+Nom
bealla	bealla+N+Sg+Nom
fealla	fealla+N+Sg+Nom
faama	faama+N+Sg+Nom
leama	leama+N+Sg+Nom
vaajma	vaajma+N+Sg+Nom
pleajma	pleajma+N+Sg+Nom
gamma	gamma+N+Sg+Nom
slamma	slamma+N+Sg+Nom
beapma	beapma+N+Sg+Nom
gaavma	gaavma+N+Sg+Nom
ratna	ratna+N+Sg+Nom
svætna	svætna+N+Sg+Nom
kravna	kravna+N+Sg+Nom
laamhpa	laamhpa+N+Sg+Nom
stramhpa	stramhpa+N+Sg+Nom
jarhpa	jarhpa+N+Sg+Nom
gampa	gampa+N+Sg+Nom
daara	daara+N+Sg+Nom
sæjra	sæjra+N+Sg+Nom
narra	narra+N+Sg+Nom
snarra	snarra+N+Sg+Nom
hårra	hårra+N+Sg+Nom
neavra	neavra+N+Sg+Nom
maajsa	maajsa+N+Sg+Nom
råaksa	råaksa+N+Sg+Nom
passa	passa+N+Sg+Nom
pååssa	pååssa+N+Sg+Nom
bånhtsa	bånhtsa+N+Sg+Nom
raavsa	raavsa+N+Sg+Nom
seadta	seadta+N+Sg+Nom
gaahta	gaahta+N+Sg+Nom
snahta	snahta+N+Sg+Nom
neajta	neajta+N+Sg+Nom
låajta	låajta+N+Sg+Nom
gæsta	gæsta+N+Sg+Nom
læsta	læsta+N+Sg+Nom
deajva	deajva+N+Sg+Nom
gaarva	gaarva+N+Sg+Nom
jaavva	jaavva+N+Sg+Nom
rotjkede	rotjkede+N+Sg+Nom
jalkede	jalkede+N+Sg+Nom
keeffe	keeffe+N+Sg+Nom
eege	eege+N+Sg+Nom
sluemege	sluemege+N+Sg+Nom
jïermege	jïermege+N+Sg+Nom
sïejpege	sïejpege+N+Sg+Nom
sïhtege	sïhtege+N+Sg+Nom
baaktege	baaktege+N+Sg+Nom
mååktege	mååktege+N+Sg+Nom
györtege	györtege+N+Sg+Nom
jonnge	jonnge+N+Sg+Nom
kaeffie	kaeffie+N+Sg+Nom
arremesijjie	arreme#sijjie+N+Sg+Nom
tsihtsehthmuerjie	tsihtsehth#muerjie+N+Sg+Nom
kraessjie	kraessjie+N+Sg+Nom
låedtjie	låedtjie+N+Sg+Nom
kristaehtjie	krist#aehtjie+N+Sg+Nom
ståeltjie	ståeltjie+N+Sg+Nom
daekie	daekie+N+Sg+Nom
jiehkie	jiehkie+N+Sg+Nom
fliehkie	fliehkie+N+Sg+Nom
moeretsåelhkie	moere#tsåelhkie+N+Sg+Nom
maerhkie	maerhkie+N+Sg+Nom
buejkie	buejkie+N+Sg+Nom
snurkie	snurkie+N+Sg+Nom
maeskie	maeskie+N+Sg+Nom
jåeskie	jåeskie+N+Sg+Nom
avtebielie	avte#bielie+N+Sg+Nom
skiesjlie	skiesjlie+N+Sg+Nom
fellie	fellie+N+Sg+Nom
liejmie	liejmie+N+Sg+Nom
lijmie	lijmie+N+Sg+Nom
rijmie	rijmie+N+Sg+Nom
sliehtie-elmie	sliehtie-elmie+N+Sg+Nom
maejnie	maejnie+N+Sg+Nom
rijnie	rijnie+N+Sg+Nom
svijnie	svijnie+N+Sg+Nom
kristietnie	krist#ietnie+N+Sg+Nom
ruhpie	ruhpie+N+Sg+Nom
nåejpie	nåejpie+N+Sg+Nom
burrie	burrie+N+Sg+Nom
surrie	surrie+N+Sg+Nom
jijsie	jijsie+N+Sg+Nom
fuersie	fuersie+N+Sg+Nom
gåersie	gåersie+N+Sg+Nom
praedtie	praedtie+N+Sg+Nom
snuhtie	snuhtie+N+Sg+Nom
baevtie	baevtie+N+Sg+Nom
heaje	heaje+N+Sg+Nom
daejrije	daejrije+N+Sg+Nom
sujhtije	sujhtije+N+Sg+Nom
majje	majje+N+Sg+Nom
hijje	hijje+N+Sg+Nom
tråjje	tråjje+N+Sg+Nom
moenje	moenje+N+Sg+Nom
satnje	satnje+N+Sg+Nom
faamoje	faamoje+N+Sg+Nom
fïerje	fïerje+N+Sg+Nom
gaarsje	gaarsje+N+Sg+Nom
gaaretje	gaaretje+N+Sg+Nom
rovhtetje	rovhtetje+N+Sg+Nom
plaahtje	plaahtje+N+Sg+Nom
borhtje	borhtje+N+Sg+Nom
kraavhtje	kraavhtje+N+Sg+Nom
gaaktje	gaaktje+N+Sg+Nom
slaptje	slaptje+N+Sg+Nom
raavtje	raavtje+N+Sg+Nom
taake	taake+N+Sg+Nom
krungke	krungke+N+Sg+Nom
bæjjadahke	bæjjadahke+N+Sg+Nom
gossehtahke	gossehtahke+N+Sg+Nom
boerestahke	boerestahke+N+Sg+Nom
reehke	reehke+N+Sg+Nom
buelehke	buelehke+N+Sg+Nom
jarpehke	jarpehke+N+Sg+Nom
urrehke	urrehke+N+Sg+Nom
tjovrehke	tjovrehke+N+Sg+Nom
væjsehke	væjsehke+N+Sg+Nom
vihtehke	vihtehke+N+Sg+Nom
åanghke	åanghke+N+Sg+Nom
moeretjåålhke	moere#tjåålhke+N+Sg+Nom
moeretjöölhke	moere#tjöölhke+N+Sg+Nom
tjeapah	tjeapohke+N+Sg+Nom
borhke	borhke+N+Sg+Nom
steavhke	steavhke+N+Sg+Nom
stïevhke	stïevhke+N+Sg+Nom
frorke	frorke+N+Sg+Nom
tjyöke	tjyöke+N+Sg+Nom
tsåeptsele	tsåeptsele+N+Sg+Nom
bodtele	bodtele+N+Sg+Nom
bohtele	bohtele+N+Sg+Nom
dalle	dalle+N+Sg+Nom
dolle	dolle+N+Sg+Nom
moeretjååle	moere#tjååle+N+Sg+Nom
seareme	seareme+N+Sg+Nom
mekseme	mekseme+N+Sg+Nom
mujhteme	mujhteme+N+Sg+Nom
båajme	båajme+N+Sg+Nom
spåajme	spåajme+N+Sg+Nom
lïjme	lïjme+N+Sg+Nom
loemme	loemme+N+Sg+Nom
låmme	låmme+N+Sg+Nom
nïmme	nïmme+N+Sg+Nom
eebne	eebne+N+Sg+Nom
angkene	angkene+N+Sg+Nom
gearene	gearene+N+Sg+Nom
påassene	påassene+N+Sg+Nom
gujne	gujne+N+Sg+Nom
botne	botne+N+Sg+Nom
tjovne	tjovne+N+Sg+Nom
jååne	jååne+N+Sg+Nom
kraassjoe	kraassjoe+N+Sg+Nom
krahtjoe	krahtjoe+N+Sg+Nom
spæntjoe	spæntjoe+N+Sg+Nom
neakoe	neakoe+N+Sg+Nom
hahkoe	hahkoe+N+Sg+Nom
klåhkoe	klåhkoe+N+Sg+Nom
hearskoe	hearskoe+N+Sg+Nom
leamoe	leamoe+N+Sg+Nom
klaajpoe	klaajpoe+N+Sg+Nom
gæmpoe	gæmpoe+N+Sg+Nom
snårroe	snårroe+N+Sg+Nom
pleasoe	pleasoe+N+Sg+Nom
bånhtsoe	bånhtsoe+N+Sg+Nom
faadtoe	faadtoe+N+Sg+Nom
gaarpe	gaarpe+N+Sg+Nom
feebere	feebere+N+Sg+Nom
fïebere	fïebere+N+Sg+Nom
fræjjere	fræjjere+N+Sg+Nom
nåhkere	nåhkere+N+Sg+Nom
næhkere	næhkere+N+Sg+Nom
baamere	baamere+N+Sg+Nom
neapere	neapere+N+Sg+Nom
ååbpere	ååbpere+N+Sg+Nom
plomstere	plomstere+N+Sg+Nom
bïere	bïere+N+Sg+Nom
traktore	traktore+N+Sg+Nom
rektore	rektore+N+Sg+Nom
horre	horre+N+Sg+Nom
duvre	duvre+N+Sg+Nom
voejmese	voejmese+N+Sg+Nom
ebriegïerese	ebrie#gïerese+N+Sg+Nom
laakse	laakse+N+Sg+Nom
kreense	kreense+N+Sg+Nom
nïekedasse	nïekedasse+N+Sg+Nom
gaarenasse	gaarenasse+N+Sg+Nom
rïsse	rïsse+N+Sg+Nom
gihtse	gihtse+N+Sg+Nom
niestiesbovtse	niesties#bovtse+N+Sg+Nom
haahte	haahte+N+Sg+Nom
tjïejhte	tjïejhte+N+Sg+Nom
sprïjhte	sprïjhte+N+Sg+Nom
johte	johte+N+Sg+Nom
jåårhte	jåårhte+N+Sg+Nom
sjåårhte	sjåårhte+N+Sg+Nom
roejte	roejte+N+Sg+Nom
moelte	moelte+N+Sg+Nom
båånte	båånte+N+Sg+Nom
tjipte	tjipte+N+Sg+Nom
prïeste	prïeste+N+Sg+Nom
haave	haave+N+Sg+Nom
raadijove	raadijove+N+Sg+Nom
boerove	boerove+N+Sg+Nom
maaksove	maaksove+N+Sg+Nom
råahtove	råahtove+N+Sg+Nom
koerve	koerve+N+Sg+Nom
gajjedh	gajjedh+N+Sg+Nom
prællah	prællah+N+Pl+Nom
gaevnieh	gaevnieh+N+Pl+Nom
sysngelh	sysngelh+N+Pl+Nom
gossehth	gossehth+N+Pl+Nom
dïere	dïere+Po
dïere	dïere+Pr
gaarmanæjja	gaarmanæjja+A+Attr
mådtege	mådtege+A+Attr
tjulhpie	tjulhpie+A+Attr
uhtsie	uhtsie+A+Attr
faamoje	faamoje+A+Attr
gaarsje	gaarsje+A+Attr
skïebtje	skïebtje+A+Attr
gearkehtje	gearkehtje+A+Attr
naaskehtje	naaskehtje+A+Attr
sjïjjehke	sjïjjehke+A+Attr
gaarsjehke	gaarsjehke+A+Attr
donghkehke	donghkehke+A+Attr
vyölkehke	vyölkehke+A+Attr
gåårkehke	gåårkehke+A+Attr
jyörkehke	jyörkehke+A+Attr
sjojmehke	sjojmehke+A+Attr
nonnehke	nonnehke+A+Attr
nynnehke	nynnehke+A+Attr
skeavehke	skeavehke+A+Attr
njalhke	njalhke+A+Attr
jabjohke	jabjohke+A+Attr
naarpohke	naarpohke+A+Attr
mïrhke	mïrhke+A+Attr
myvhke	myvhke+A+Attr
dïetjke	dïetjke+A+Attr
gïerkeske	gïerkeske+A+Attr
geesjele	geesjele+A+Attr
stååpele	stååpele+A+Attr
jalle	jalle+A+Attr
jaabne	jaabne+A+Attr
jïebne	jïebne+A+Attr
jeene	jeene+A+Attr
jarpe	jarpe+A+Attr
sïerre	sïerre+A+Attr
aavre	aavre+A+Attr
njoetse	njoetse+A+Attr
gabte	gabte+A+Attr
gaaste	gaaste+A+Attr
sïejve	sïejve+A+Attr
dolve	dolve+A+Attr
tjïerve	tjïerve+A+Attr
tjakngah	tjakngah+A+Attr
laabjah	laabjah+A+Attr
jabjah	jabjah+A+Attr
kråabjah	kråabjah+A+Attr
skalnjah	skalnjah+A+Attr
skålnjah	skålnjah+A+Attr
sleadtjah	sleadtjah+A+Attr
steadtjah	steadtjah+A+Attr
kråavhtjah	kråavhtjah+A+Attr
båavjah	båavjah+A+Attr
bagkah	bagkah+A+Attr
dearkah	dearkah+A+Attr
jåamah	jåamah+A+Attr
leapmah	leapmah+A+Attr
låabpah	låabpah+A+Attr
jarhpah	jarhpah+A+Attr
jåampah	jåampah+A+Attr
garrah	garrah+A+Attr
jåasah	jåasah+A+Attr
snjadtsah	snjadtsah+A+Attr
råadtsah	råadtsah+A+Attr
japtsah	japtsah+A+Attr
meartsah	meartsah+A+Attr
klåadtah	klåadtah+A+Attr
båajhtah	båajhtah+A+Attr
geamtah	geamtah+A+Attr
båantah	båantah+A+Attr
gaastah	gaastah+A+Attr
åajvah	åajvah+A+Attr
kråavvah	kråavvah+A+Attr
tjåkngoeh	tjåkngoeh+A+Attr
laabjoeh	laabjoeh+A+Attr
jabjoeh	jabjoeh+A+Attr
kråabjoeh	kråabjoeh+A+Attr
speanjoeh	speanjoeh+A+Attr
sleadtjoeh	sleadtjoeh+A+Attr
steadtjoeh	steadtjoeh+A+Attr
pleahtjoeh	pleahtjoeh+A+Attr
kranghtjoeh	kranghtjoeh+A+Attr
krånhtjoeh	krånhtjoeh+A+Attr
kråavhtjoeh	kråavhtjoeh+A+Attr
kråaptjoeh	kråaptjoeh+A+Attr
bagkoeh	bagkoeh+A+Attr
bågkoeh	bågkoeh+A+Attr
dånghkoeh	dånghkoeh+A+Attr
vealoeh	vealoeh+A+Attr
hagloeh	hagloeh+A+Attr
falloeh	falloeh+A+Attr
sjalloeh	sjalloeh+A+Attr
njavloeh	njavloeh+A+Attr
leapmoeh	leapmoeh+A+Attr
jåabpoeh	jåabpoeh+A+Attr
skråajhpoeh	skråajhpoeh+A+Attr
galhpoeh	galhpoeh+A+Attr
gålhpoeh	gålhpoeh+A+Attr
båmhpoeh	båmhpoeh+A+Attr
skabroeh	skabroeh+A+Attr
fæjhroeh	fæjhroeh+A+Attr
båavhroeh	båavhroeh+A+Attr
haarroeh	haarroeh+A+Attr
tåasoeh	tåasoeh+A+Attr
rapsoeh	rapsoeh+A+Attr
råpsoeh	råpsoeh+A+Attr
radtsoeh	radtsoeh+A+Attr
jånhtsoeh	jånhtsoeh+A+Attr
hartsoeh	hartsoeh+A+Attr
hårtsoeh	hårtsoeh+A+Attr
klåabtoeh	klåabtoeh+A+Attr
gaastoeh	gaastoeh+A+Attr
gåavoeh	gåavoeh+A+Attr
laahvoeh	laahvoeh+A+Attr
kråavvoeh	kråavvoeh+A+Attr
sjeavehth	sjeavehth+A+Attr
sjaavohth	sjaavohth+A+Attr
bahhas	bahhas+A+Attr
suajas	suajas+A+Attr
tjeakas	tjeakas+A+Attr
ræjhkas	ræjhkas+A+Attr
jåalhkas	jåalhkas+A+Attr
hearhkas	hearhkas+A+Attr
mævhkas	mævhkas+A+Attr
maskas	maskas+A+Attr
hearskas	hearskas+A+Attr
måskas	måskas+A+Attr
svaalas	svaalas+A+Attr
sæjlas	sæjlas+A+Attr
fraapmas	fraapmas+A+Attr
hajnas	hajnas+A+Attr
nannas	nannas+A+Attr
nænnas	nænnas+A+Attr
låabpas	låabpas+A+Attr
hamhpas	hamhpas+A+Attr
våaras	våaras+A+Attr
seadtas	seadtas+A+Attr
båantas	båantas+A+Attr
prïhtjeds	prïhtjeds+A+Attr
lïebkeds	lïebkeds+A+Attr
smaekeds	smaekeds+A+Attr
njalhkeds	njalhkeds+A+Attr
luvkeds	luvkeds+A+Attr
joeleds	joeleds+A+Attr
njahpeds	njahpeds+A+Attr
snjahpeds	snjahpeds+A+Attr
jemhkelds	jemhkelds+A+Attr
lujjies	lujjies+A+Attr
vissjies	vissjies+A+Attr
prihtjies	prihtjies+A+Attr
traegkies	traegkies+A+Attr
buejkies	buejkies+A+Attr
jåeskies	jåeskies+A+Attr
friskies	friskies+A+Attr
baetskies	baetskies+A+Attr
smaejlies	smaejlies+A+Attr
gijmies	gijmies+A+Attr
sluenies	sluenies+A+Attr
snaehpies	snaehpies+A+Attr
giehpies	giehpies+A+Attr
verries	verries+A+Attr
murries	murries+A+Attr
nievries	nievries+A+Attr
vieksies	vieksies+A+Attr
gåersies	gåersies+A+Attr
låebties	låebties+A+Attr
njuevies	njuevies+A+Attr
gaarkijes	gaarkijes+A+Attr
gearkijes	gearkijes+A+Attr
naaskijes	naaskijes+A+Attr
fååmijes	fååmijes+A+Attr
krobpijes	krobpijes+A+Attr
kraavhpijes	kraavhpijes+A+Attr
tråjjes	tråjjes+A+Attr
göövjes	göövjes+A+Attr
bïegkes	bïegkes+A+Attr
jarhkes	jarhkes+A+Attr
naaskes	naaskes+A+Attr
liskes	liskes+A+Attr
tjoevkes	tjoevkes+A+Attr
skïebtjeles	skïebtjeles+A+Attr
vietjeles	vietjeles+A+Attr
jemhkeles	jemhkeles+A+Attr
naaskeles	naaskeles+A+Attr
voemeles	voemeles+A+Attr
sehpeles	sehpeles+A+Attr
vedteles	vedteles+A+Attr
bïevles	bïevles+A+Attr
doemes	doemes+A+Attr
frååpmes	frååpmes+A+Attr
hearhkoes	hearhkoes+A+Attr
svaaloes	svaaloes+A+Attr
vaajmoes	vaajmoes+A+Attr
låabpoes	låabpoes+A+Attr
haarroes	haarroes+A+Attr
båadtsoes	båadtsoes+A+Attr
dabtoes	dabtoes+A+Attr
båarhtoes	båarhtoes+A+Attr
damtoes	damtoes+A+Attr
båantoes	båantoes+A+Attr
laahvoes	laahvoes+A+Attr
geamhpes	geamhpes+A+Attr
feahperes	feahperes+A+Attr
bohteres	bohteres+A+Attr
boevteres	boevteres+A+Attr
joevteres	joevteres+A+Attr
tjarres	tjarres+A+Attr
veerres	veerres+A+Attr
soptses	soptses+A+Attr
bööntes	bööntes+A+Attr
nuhtegs	nuhtegs+A+Attr
isveligs	isveligs+A+Attr
vyljehks	vyljehks+A+Attr
guelehks	guelehks+A+Attr
vuasehks	vuasehks+A+Attr
saelhtehks	saelhtehks+A+Attr
prïhtjedihks	prïhtjedihks+A+Attr
vadtedihks	vadtedihks+A+Attr
sehpieldihks	sehpieldihks+A+Attr
vååjeldihks	vååjeldihks+A+Attr
gilvelihks	gilvelihks+A+Attr
sjaevehts	sjaevehts+A+Attr
evtebe	evtebe+A+Comp+Attr
uvtebe	uvtebe+A+Comp+Attr
verkebe	verkebe+Adv
kranhtjode	kranhtjode+Adv
hamhpode	hamhpode+Adv
baaktege	baaktege+Adv
isveligkie	isveligkie+Adv
geeruvisnie	geeruvisnie+Adv
aaptsah	aaptsah+Adv
aaptsh	aaptsh+Adv
guarjan	guarjan+Adv
gællan	gællan+Adv
