bagkesidh	v	påstå, pukke på sin mening
bïevestovvedh	v	svette, bli svett
dienesjidh	v	tjene, være tjener; tjene penger
eadtjoestidh	v	drive, tilskynde
kråvvadidh	v	grue seg
mïrrestalledh	v	være jevnbyrdig, likestilles
sjiehtesjadtedh	v	tilrettelegge
vïedtjedh	v	hente
åahpanadtedh	v	å bli kjent (med flere)
aajmone	adv	i behold, igjen
aajtoe	n	stor ild
aamhtese	n	tema
aarvoe	n	mening
aassjoe	n	hat
aejkie	n	stund; tid
aejvere	n	bekymring, melankolisk sinn
aevhkies	a	nyttig
ajve	adv	bare
astoe	n	god tid (til noe)
bangseme	n	leppe
baste	n	klemme, tang
beajjetje	a	som er fra den og den dag
beetsuve	n	til overs
bene	cs	jo, men, vel, kanskje
biehtedæjja	n	sviker
biehteme	n	bedrag
duvrie	n	bjørn
bongke	n	lommebok
bualahtahke	n	brennevin
byjjes	a	offentlig
byjreske	n	miljø, omgivelse; lokalitet
byøgkeles	a	egn, sted, som alltid slir passert
båajhtode	adv	uredelig, galt, feil
bååhpere	n	forundring
bæjhkoehtimmie	n	erklæring; meddelelse
daajroe	n	kunnskap, viten
dearkoes	a	nervøs
dïjre	n	budskap
ditnie	n	tinn; tinntråd
dohpere	n	blomsterkrans
dåaroe	n	krig, strid
dåeriesmoere	n	vanskelighet
dåårrehtidh	n	skaffe til veie, sørge for
eadtjohke	n	ivrig; modig, energisk
eeremes	cs	aller helst 
eevre	adv	akkurat, aldeles, helt og holdent
ektievoete	n	enhet
fejjen	a	glad 
tjoere	n	flue	
fïere	adv	hver
gaaje	n	sladder
gaajhkesh	Pron Coll Pl% alle sammen
gaavnoes	a	som finnes
garre	a	hard
gujht	pcle	nok
gåevie	n	krumming, bue
gåffoeh	a	sen i oppfattelsen, dum
gïemhpe	a	snill
gïetske	po	nær
gïetske	pr	nær
heamture	n	eventyr
hïelje	n	helg 
hååneske	n	honning
vöönhtse	n	høne	
identiteete	n	identitet
ïebne	n	emne
iemie-laakan	adv	på naturlig vis
institusjovne	n	institusjon
jearsoes	a	trygg, tillitsfull
jiehtege	n	setning
jïermijes	a	klokt
klaasse	n	klasse
ladtetje	n	liten fugl
lïene	a	lunken (om vann)
låagkoeh	a	arbeidssky, ynkelig sutrete
læhkoe	n	lykke
læhkoeladtje	a	heldig, en som er heldig
læjhkan	cs	likevel
læjhkan	adv	likevel
lïjhke	n	likevel
mahte	adv	nesten
mïelke	n	bryst, bringe 
mårve	n	en som er irritabel
naapere	n	bor
njaalmeldh	a	muntlig
njaltja	n	skinn, hud
njamma	n	kvinnebryst, brystvorte
nåajsan	a	gravid
nænnoes	a	sterk
ov-luhpehts	a	ulovlig
ovmessie	a	ulike, forskjellige
ovvissjeles	a	utålmodig
piggsvin	n	deblie
plaerie	n	blad (av plante, bok, kniv); avis
plievhties	a	betatt
raerie	n	råd
reakta	n	rettighet
rovnegs	a	underlig, rar
råantja	n	reinsbukk
råavka	n	skinnfell
rådyr	n	råase
ræjhkoes	a	rik
sagke	adv	meget
sapte	n	skum 
sealoe	n	sjel 
seareme	n	kinn; kinnbein
searome	n	kinn; kinnbein
seknie	n	utilfredshet, irritasjon
sieties	a	søte
sïeve	n	strek
sisvege	n	innhold
sjeavodh	a	stille, tyst
sjiehteles	a	passende
skåape	n	skap
skåltoe	n	skyld
smaarege	n	dialekt
soejvene	n	skygge
såarkoe	n	sorg
sæjroe	n	side (av eks menneske, dyr)
sïejhme	a	vanlig
tjahkan	a	sittende
tjalke	n	spytt
tjalmerge	a	skarpsynt
tjeakoes	a	hemmelig, skjult
tjevties	a	fast (om kjøtt og fisk)
tjihtese	n	dikt
tjoevtenje	n	nøkkel
tjuavkeds	a	lys
tjåanghkoe	n	samling
ulmie	n	betydning, mening; mål
våarome	n	grunnlag
vætnoe	n	arbeid, handarbeid
åssjalommes	n	tanke, idè
åtnoe	n	bruk
