!vuentiemie	!vuen^tie^mie
aagkele	aag^ke^le
aaguste	aa^gus^te
aahkove	aah^ko^ve
aahkuve	aah^ku^ve
aajhtere	aajh^te^re
aajjove	aaj^jo^ve
aajjuve	aaj^ju^ve
aajkohke	aaj^koh^ke
aajnehke	aaj^neh^ke
aajngese	aaj^nge^se
aalhkije	aalh^ki^je
aalhtere	aalh^te^re
aallije	aal^li^je
aallohke	aal^loh^ke
aalmehke	aal^meh^ke
aalmoge	aal^mo^ge
aalohke	aa^loh^ke
aaltehke	aal^teh^ke
aaltere	aal^te^re
aamhtese	aamh^te^se
aamhtshreerije	aamhtshree^ri^je
aamore	aa^mo^re
aanghkere	aangh^ke^re
aanoje	aa^no^je
aarehke	aa^reh^ke
aarije	aa^ri^je
aarpere	aar^pe^re
aarpije	aar^pi^je
aartege	aar^te^ge
aasohte	aa^soh^te
aavjere	aav^je^re
aavroske	aav^ros^ke
abpere	ab^pe^re
abpese	ab^pe^se
adjunkte	ad^junk^te
adtjeme	ad^tje^me
aejlege	aej^le^ge
aejvere	aej^ve^re
aerede	ae^re^de
aevlerge	aev^ler^ge
aktore	ak^to^re
aktööre	ak^töö^re
almetje	al^me^tje
altese	al^te^se
alvehtse	al^veh^tse
anghkele	angh^ke^le
angkene	ang^ke^ne
arrije	ar^ri^je
autore	au^to^re
avtehke	av^teh^ke
baabele	baa^be^le
baahkese	baah^ke^se
baahtsege	baah^tse^ge
baaktege	baak^te^ge
baaktetje	baak^te^tje
baaktjese	baak^tje^se
baaletje	baa^le^tje
baalkohke	baal^koh^ke
baamere	baa^me^re
baantjere	baan^tje^re
baapelge	baa^pel^ge
baarhkohke	baarh^koh^ke
baarnetje	baar^ne^tje
baartege	baar^te^ge
baastese	baas^te^se
baavlese	baav^le^se
baedteme	baed^te^me
baehpere	baeh^pe^re
baektehke	baek^teh^ke
baelije	bae^li^je
baenehke	bae^neh^ke
baerehke	bae^reh^ke
baersele	baer^se^le
baetjkere	baetj^ke^re
bahtsehke	bah^tseh^ke
bajsjeme	baj^sje^me
balhkere	balh^ke^re
baltehke	bal^teh^ke
baltohke	bal^toh^ke
baltove	bal^to^ve
bangseme	bang^se^me
bankeme	ban^ke^me
barkeme	bar^ke^me
barkije	bar^ki^je
bartese	bar^te^se
bastege	bas^te^ge
bastese	bas^te^se
beajjetje	beaj^je^tje
beajvese	beaj^ve^se
beakere	bea^ke^re
bealbere	beal^be^re
bealjege	bea^lje^ge
bealjese	bea^lje^se
bealjetje	bea^lje^tje
bealketje	beal^ke^tje
beallohke	beal^loh^ke
bealpere	beal^pe^re
bearehke	bea^reh^ke
beavnere	beav^ne^re
beeletje	bee^le^tje
beeljese	bee^lje^se
beeretje	bee^re^tje
beetsehke	bee^tseh^ke
beetsetje	bee^tse^tje
beetsuve	bee^tsu^ve
bejseme	bej^se^me
bejsjeme	bej^sje^me
berteme	ber^te^me
bertije	ber^ti^je
biehteme	bieh^te^me
bietsehke	bie^tseh^ke
bievnehke	biev^neh^ke
bievrehke	biev^reh^ke
bigkeme	big^ke^me
bijjeske	bij^jes^ke
bijpele	bij^pe^le
bisseme	bis^se^me
blæjjohke	blæj^joh^ke
bodtele	bod^te^le
boedove	boe^do^ve
boehtele	boeh^te^le
boejege	boe^je^ge
boelhketje	boelh^ke^tje
boenege	boe^ne^ge
boenehke	boe^neh^ke
boennehke	boen^neh^ke
boerege	boe^re^ge
boerese	boe^re^se
boerove	boe^ro^ve
boffere	bof^fe^re
bohkere	boh^ke^re
bohtele	boh^te^le
bolhkere	bolh^ke^re
bollege	bol^le^ge
bollere	bol^le^re
boltehke	bol^teh^ke
bommulle	bom^mul^le
bomstere	bom^ste^re
bonhkele	bonh^ke^le
bontege	bon^te^ge
bortege	bor^te^ge
botnjese	bot^nje^se
bovrege	bov^re^ge
bualehke	bua^leh^ke
buarkere	buar^ke^re
buartetje	buar^te^tje
budtese	bud^te^se
buekteme	buek^te^me
buelehke	bue^leh^ke
buhtehke	buh^teh^ke
buhtjije	buh^tji^je
bullere	bul^le^re
bulpere	bul^pe^re
bustetje	bus^te^tje
buvveme	buv^ve^me
buvvije	buv^vi^je
byjngetje	byj^nge^tje
byjrese	byj^re^se
byjreske	byj^res^ke
byölletje	byöl^le^tje
byörketje	byör^ke^tje
byössege	byös^se^ge
byötskeme	byöts^ke^me
byövrehke	byöv^reh^ke
båarkere	båar^ke^re
båastohke	båas^toh^ke
båeruje	båe^ru^je
båerule	båe^ru^le
båeruve	båe^ru^ve
bååhpere	bååh^pe^re
bååhtjere	bååh^tje^re
båårese	båå^re^se
bæsmere	bæs^me^re
bïehkere	bïeh^ke^re
bïekere	bïe^ke^re
bïeljese	bïe^lje^se
bïeltene	bïel^te^ne
bïerjese	bïer^je^se
bïevnese	bïev^ne^se
bïevstere	bïev^ste^re
bïjvele	bïj^ve^le
bïrhketje	bïrh^ke^tje
bïskohpe	bïs^koh^pe
bïsseme	bïs^se^me
bïssije	bïs^si^je
bööhmere	bööh^me^re
daajhtije	daajh^ti^je
daakteme	daak^te^me
daalhkese	daalh^ke^se
daamehke	daa^meh^ke
daanghkere	daangh^ke^re
daanhtsere	daanht^se^re
daanhtsoje	daanht^so^je
daatore	daa^to^re
daavlese	daav^le^se
daejdeme	daej^de^me
daejdije	daej^di^je
daejreme	daej^re^me
daejrije	daej^ri^je
daevere	dae^ve^re
dahkese	dah^ke^se
dahpese	dah^pe^se
daktege	dak^te^ge
daktere	dak^te^re
daltese	dal^te^se
dalvese	dal^ve^se
damtehtje	dam^teh^tje
damtese	dam^te^se
damtije	dam^ti^je
darjome	dar^jo^me
dassije	das^si^je
davhkese	davh^ke^se
davvoje	dav^vo^je
davvome	dav^vo^me
deadtove	dead^to^ve
deahtehke	deah^teh^ke
deakehke	dea^keh^ke
deanere	dea^ne^re
deavene	dea^ve^ne
deehtehke	deeh^teh^ke
dieltehke	diel^teh^ke
dijnege	dij^ne^ge
diskose	dis^ko^se
ditnehke	dit^neh^ke
dobtese	dob^te^se
doedtere	doed^te^re
doedtije	doed^ti^je
doekije	doe^ki^je
doelese	doe^le^se
doelteme	doel^te^me
doenehke	doe^neh^ke
doengese	doe^nge^se
doerehke	doe^reh^ke
dogkese	dog^ke^se
dohkese	doh^ke^se
dohpere	doh^pe^re
doksetje	dok^se^tje
dompere	dom^pe^re
domtese	dom^te^se
dontere	don^te^re
dorjese	dor^je^se
dorkeme	dor^ke^me
dotkeme	dot^ke^me
dotkije	dot^ki^je
dotnele	dot^ne^le
dovhkere	dovh^ke^re
dovnore	dov^no^re
dovtege	dov^te^ge
dualjetje	dua^lje^tje
duamere	dua^me^re
dussine	dus^si^ne
duvtuve	duv^tu^ve
duvvege	duv^ve^ge
duvvehke	duv^veh^ke
dyjnege	dyj^ne^ge
dytnele	dyt^ne^le
dyödtove	dyöd^to^ve
dyölehke	dyö^leh^ke
dyölhkese	dyölh^ke^se
dåaktere	dåak^te^re
dåarjege	dåar^je^ge
dåarjome	dåar^jo^me
dåarmetje	dåar^me^tje
dåarohke	dåa^roh^ke
dåarohtje	dåa^roh^tje
dåaroje	dåa^ro^je
dåarome	dåa^ro^me
dåastoje	dåas^to^je
dåastove	dåas^to^ve
dårretje	dår^re^tje
dåvhketje	dåvh^ke^tje
dåvretje	dåv^re^tje
dåvvoje	dåv^vo^je
dååbpese	dååb^pe^se
dååpmehke	dååp^meh^ke
dååsketje	dåås^ke^tje
dååsmere	dåås^me^re
dååstove	dåås^to^ve
dæhketje	dæh^ke^tje
dïedtije	dïed^ti^je
dïedtove	dïed^to^ve
dïejvese	dïej^ve^se
dïempere	dïem^pe^re
dïenesje	dïe^ne^sje
dïeneste	dïe^nes^te
dïeskere	dïes^ke^re
dïjnege	dïj^ne^ge
dïjnehke	dïj^neh^ke
dïmhpere	dïmh^pe^re
dïmpere	dïm^pe^re
dïpmije	dïp^mi^je
dïrrege	dïr^re^ge
dïtnele	dït^ne^le
dööhtjere	dööh^tje^re
eadtjohke	ead^tjoh^ke
eadtjoje	ead^tjo^je
eahpele	eah^pe^le
eahpere	eah^pe^re
eajkede	eaj^ke^de
eajmeske	eaj^mes^ke
eakere	ea^ke^re
earene	ea^re^ne
eatneme	eat^ne^me
ebrehke	eb^reh^ke
ebrene	eb^re^ne
eejtege	eej^te^ge
eelege	ee^le^ge
eengkele	eeng^ke^le
eepose	ee^po^se
eeptsege	eep^tse^ge
eerpije	eer^pi^je
eesele	ee^se^le
eetere	ee^te^re
elmede	el^me^de
etnije	et^ni^je
etnose	et^no^se
faadtere	faad^te^re
faahtele	faah^te^le
faalehtje	faa^leh^tje
faamoje	faa^mo^je
faerede	fae^re^de
faktore	fak^to^re
feabpore	feab^po^re
fealpere	feal^pe^re
feebere	fee^be^re
feelege	fee^le^ge
feeleme	fee^le^me
feelije	fee^li^je
fellehke	fel^leh^ke
fijfere	fij^fe^re
fitnele	fit^ne^le
flyjjere	flyj^je^re
foekehke	foe^keh^ke
foekese	foe^ke^se
foetere	foe^te^re
fosfore	fos^fo^re
fropmehke	frop^meh^ke
frypmehke	fryp^meh^ke
fræjjere	fræj^je^re
fuabtetje	fuab^te^tje
fuamtetje	fuam^te^tje
fuerege	fue^re^ge
fyjletje	fyj^le^tje
fyölletje	fyöl^le^tje
fåvrehke	fåv^reh^ke
fååhpere	fååh^pe^re
fååjsetje	fååj^se^tje
fååretje	fåå^re^tje
fæjretje	fæj^re^tje
fæskere	fæs^ke^re
fïebere	fïe^be^re
fïerpene	fïer^pe^ne
fïerpese	fïer^pe^se
fïtnele	fït^ne^le
gaagkije	gaag^ki^je
gaahtjeme	gaah^tje^me
gaajmere	gaaj^me^re
gaajsege	gaaj^se^ge
gaajvele	gaaj^ve^le
gaallohke	gaal^loh^ke
gaalmetje	gaal^me^tje
gaalsohke	gaal^soh^ke
gaaltenje	gaal^te^nje
gaaltije	gaal^ti^je
gaamese	gaa^me^se
gaampelde	gaam^pel^de
gaampetje	gaam^pe^tje
gaapele	gaa^pe^le
gaaptese	gaap^te^se
gaarene	gaa^re^ne
gaaretje	gaa^re^tje
gaarhkese	gaarh^ke^se
gaartije	gaar^ti^je
gaasije	gaa^si^je
gaatene	gaa^te^ne
gaavtjetje	gaav^tje^tje
gablehke	gab^leh^ke
gadtere	gad^te^re
gadtsenje	gad^tse^nje
gadtsese	gad^tse^se
gaeblehke	gaeb^leh^ke
gaejnele	gaej^ne^le
gaejnjele	gaej^nje^le
gaejvehke	gaej^veh^ke
gaekere	gae^ke^re
gaektjehke	gaek^tjeh^ke
gaengkere	gaeng^ke^re
gaeptehke	gaep^teh^ke
gaerjele	gaer^je^le
gaerpene	gaer^pe^ne
gaertene	gaer^te^ne
gaetskehke	gaets^keh^ke
gaetskeme	gaets^ke^me
gaevnese	gaev^ne^se
gaffele	gaf^fe^le
gajhkeme	gajh^ke^me
gajhkije	gajh^ki^je
gajvije	gaj^vi^je
galhkuve	galh^ku^ve
galkeme	gal^ke^me
galkije	gal^ki^je
galkuve	gal^ku^ve
galmese	gal^me^se
galtege	gal^te^ge
gamtjese	gam^tje^se
gaptese	gap^te^se
gaptjese	gap^tje^se
garrese	gar^re^se
gaskeme	gas^ke^me
gaskese	gas^ke^se
gasnege	gas^ne^ge
gasngese	gas^nge^se
geabnetje	geab^ne^tje
gearene	gea^re^ne
gearketje	gear^ke^tje
geaselme	gea^sel^me
geehtije	geeh^ti^je
geejmese	geej^me^se
geellege	geel^le^ge
geepehke	gee^peh^ke
geeruve	gee^ru^ve
gejhkehke	gejh^keh^ke
gengsjehke	gengs^jeh^ke
genhtseme	genht^se^me
gerngere	ger^nge^re
gerpere	ger^pe^re
gertele	ger^te^le
giebrese	gieb^re^se
giedtese	gied^te^se
gierehtse	gie^reh^tse
gierese	gie^re^se
giernehke	gier^neh^ke
gieruve	gie^ru^ve
gieseme	gie^se^me
gihpere	gih^pe^re
gilkije	gil^ki^je
gilkuve	gil^ku^ve
girrehke	gir^reh^ke
glovrije	glov^ri^je
godtsenje	god^tse^nje
goebleme	goeb^le^me
goebpere	goeb^pe^re
goehksege	goehk^se^ge
goehmele	goeh^me^le
goeksege	goek^se^ge
goelmese	goel^me^se
goelpene	goel^pe^ne
goengere	goe^nge^re
goepege	goe^pe^ge
goepehke	goe^peh^ke
goerehtje	goe^reh^tje
goerhtele	goerh^te^le
goerkese	goer^ke^se
goesehke	goe^seh^ke
goesmere	goes^me^re
goetsehtje	goe^tseh^tje
goevele	goe^ve^le
goevtese	goev^te^se
goffere	gof^fe^re
gohpege	goh^pe^ge
gohtere	goh^te^re
gojkele	goj^ke^le
golkehke	gol^keh^ke
gommere	gom^me^re
gomtjele	gom^tje^le
gonhtehke	gonh^teh^ke
gorrese	gor^re^se
gossehtse	gos^seh^tse
govkije	gov^ki^je
govvese	gov^ve^se
gratsije	gra^tsi^je
grævlinge	græv^li^nge
gualetje	gua^le^tje
guassetje	guas^se^tje
guddeme	gud^de^me
guedehtje	gue^deh^tje
guedtede	gued^te^de
guedteme	gued^te^me
guedtije	gued^ti^je
guehpere	gueh^pe^re
guelhtehke	guelh^teh^ke
guenhtehke	guenh^teh^ke
guerehtje	gue^reh^tje
guesehke	gue^seh^ke
guevtele	guev^te^le
guhpege	guh^pe^ge
guhpehke	guh^peh^ke
guhtsije	guh^tsi^je
guksese	guk^se^se
gurrelme	gur^rel^me
gurreme	gur^re^me
gurrije	gur^ri^je
gurruve	gur^ru^ve
gutnije	gut^ni^je
gyhpele	gyh^pe^le
gyhpenje	gyh^pe^nje
gyhtsele	gyh^tse^le
gymnaase	gym^naa^se
gyrrehke	gyr^reh^ke
gyöjnetje	gyöj^ne^tje
gyöletje	gyö^le^tje
gyölleme	gyöl^le^me
gyöngere	gyö^nge^re
gyönjere	gyö^nje^re
györtege	györ^te^ge
györtenje	györ^te^nje
gyösehke	gyö^seh^ke
gyövngere	gyöv^nge^re
gyövnjere	gyöv^nje^re
gåajpehtje	gåaj^peh^tje
gåangkohtje	gåang^koh^tje
gåaroje	gåa^ro^je
gåarome	gåa^ro^me
gåatome	gåa^to^me
gåavene	gåa^ve^ne
gåblohke	gåb^loh^ke
gåebleme	gåeb^le^me
gåehpele	gåeh^pe^le
gåehtjeme	gåeh^tje^me
gåehtjere	gåeh^tje^re
gåehtsuve	gåeh^tsu^ve
gåeskuve	gåes^ku^ve
gåetehke	gåe^teh^ke
gåptose	gåp^to^se
gårmehke	går^meh^ke
gårrije	går^ri^je
gåtnere	gåt^ne^re
gååjhkehtse	gååjh^keh^tse
gååjnetje	gååj^ne^tje
gååjpese	gååj^pe^se
gååjvetje	gååj^ve^tje
gåålese	gåå^le^se
gåållese	gåål^le^se
gåålletje	gåål^le^tje
gååmsetje	gååm^se^tje
gåångketje	gåång^ke^tje
gåårtenje	gåår^te^nje
gåårtese	gåår^te^se
gæjmohtje	gæj^moh^tje
gæjsjeme	gæj^sje^me
gæljoje	gæ^ljo^je
gæmhpome	gæmh^po^me
gïehkeme	gïeh^ke^me
gïejetje	gïe^je^tje
gïeltege	gïel^te^ge
gïemhpese	gïemh^pe^se
gïerene	gïe^re^ne
gïerese	gïe^re^se
gïerhkeme	gïerh^ke^me
gïerkehtse	gïer^keh^tse
gïermesje	gïer^me^sje
gïesehke	gïe^seh^ke
gïetkeme	gïet^ke^me
gïhpetje	gïh^pe^tje
gïhtere	gïh^te^re
gïknjele	gïk^nje^le
gïrrehke	gïr^reh^ke
gïtnjele	gït^nje^le
gööleme	göö^le^me
göölije	göö^li^je
haakene	haa^ke^ne
haalehke	haa^leh^ke
haarsese	haar^se^se
haartege	haar^te^ge
haerjeme	haer^je^me
haesteme	haes^te^me
halkere	hal^ke^re
hamstere	ham^ste^re
harrije	har^ri^je
hartege	har^te^ge
hassehke	has^seh^ke
havketje	hav^ke^tje
heamture	heam^tu^re
heantije	hean^ti^je
hearkeske	hear^kes^ke
heelsege	heel^se^ge
heerrehke	heer^reh^ke
hektove	hek^to^ve
herrehke	her^reh^ke
hierkeme	hier^ke^me
hierkeske	hier^kes^ke
hompere	hom^pe^re
hopmele	hop^me^le
huhteme	huh^te^me
hummere	hum^me^re
hurrehke	hur^reh^ke
hussege	hus^se^ge
huvmore	huv^mo^re
hyölmesje	hyöl^me^sje
hyörvetje	hyör^ve^tje
håaleme	håa^le^me
håantjeme	håan^tje^me
håålhketje	håålh^ke^tje
hååneske	håå^nes^ke
hïejhtege	hïejh^te^ge
iehkede	ieh^ke^de
ierhtehke	ierh^teh^ke
ihkuve	ih^ku^ve
jaavretje	jaav^re^tje
jaavvotje	jaav^vo^tje
jadtove	jad^to^ve
jaemede	jae^me^de
jaememe	jae^me^me
jahkeske	jah^kes^ke
jahtege	jah^te^ge
jalkede	jal^ke^de
jalleme	jal^le^me
jarpehke	jar^peh^ke
jarreme	jar^re^me
jearmetje	jear^me^tje
jeeluve	jee^lu^ve
jeemege	jee^me^ge
jeestere	jees^te^re
jehkede	jeh^ke^de
jemhkelde	jemh^kel^de
jemhkele	jemh^ke^le
jestije	jes^ti^je
jiegkuve	jieg^ku^ve
jiehtege	jieh^te^ge
jiehtese	jieh^te^se
jiekuve	jie^ku^ve
jielede	jie^le^de
jieleme	jie^le^me
jielije	jie^li^je
jievege	jie^ve^ge
jijhteme	jijh^te^me
jijmuve	jij^mu^ve
jillehtje	jil^leh^tje
jipmele	jip^me^le
jirrede	jir^re^de
jobnetje	job^ne^tje
joejkeme	joej^ke^me
joejtehtse	joej^teh^tse
joekehtse	joe^keh^tse
joevege	joe^ve^ge
joevjeme	joev^je^me
johketje	joh^ke^tje
joksege	jok^se^ge
jollehke	jol^leh^ke
jovjeme	jov^je^me
jovkije	jov^ki^je
juhteme	juh^te^me
juhtije	juh^ti^je
jumpere	jum^pe^re
junkije	jun^ki^je
jupmele	jup^me^le
jyjsege	jyj^se^ge
jyjseme	jyj^se^me
jyssetje	jys^se^tje
jårrese	jår^re^se
jïddeme	jïd^de^me
jïenehke	jïe^neh^ke
jïeneme	jïe^ne^me
jïermege	jïer^me^ge
jïevege	jïe^ve^ge
jïhpege	jïh^pe^ge
jïhpehke	jïh^peh^ke
jïjseme	jïj^se^me
jïrrege	jïr^re^ge
jïrreme	jïr^re^me
jöömmetje	jööm^me^tje
kaanove	kaa^no^ve
kaarretje	kaar^re^tje
kaasuse	kaa^su^se
kapsele	kap^se^le
keebrege	keeb^re^ge
keebrehke	keeb^reh^ke
ketsjupe	kets^ju^pe
klaabpere	klaab^pe^re
klaampere	klaam^pe^re
klaatere	klaa^te^re
klijneme	klij^ne^me
klobpehke	klob^peh^ke
kloemese	kloe^me^se
klohtjege	kloh^tje^ge
klohtjetje	kloh^tje^tje
klomhpehke	klomh^peh^ke
kluhtere	kluh^te^re
klåhkere	klåh^ke^re
klååjpetje	klååj^pe^tje
klååkeme	klåå^ke^me
klïjvere	klïj^ve^re
klïngkere	klïng^ke^re
klöösehke	klöö^seh^ke
kosmose	kos^mo^se
kovlone	kov^lo^ne
kraasetje	kraa^se^tje
kreebpege	kreeb^pe^ge
kroehkenje	kroeh^ke^nje
kruhtere	kruh^te^re
krååvehke	kråå^veh^ke
krååvese	kråå^ve^se
kuahpere	kuah^pe^re
kurdere	kur^de^re
kvestore	kves^to^re
kåahpere	kåah^pe^re
laadtege	laad^te^ge
laajpetje	laaj^pe^tje
laatege	laa^te^ge
laatjove	laa^tjo^ve
laavkeme	laav^ke^me
laavkome	laav^ko^me
laavloje	laav^lo^je
laavlome	laav^lo^me
ladtetje	lad^te^tje
laejhteme	laejh^te^me
laejjere	laej^je^re
laejvere	laej^ve^re
laemehke	lae^meh^ke
lahtese	lah^te^se
leajpetje	leaj^pe^tje
learohke	lea^roh^ke
learrehte	lear^reh^te
leavsetje	leav^se^tje
leejjege	leej^je^ge
leerehte	lee^reh^te
lejjone	lej^jo^ne
lektore	lek^to^re
lesbose	les^bo^se
liebkede	lieb^ke^de
liejmehke	liej^meh^ke
liemkede	liem^ke^de
lierrehte	lier^reh^te
lijhtere	lijh^te^re
lijnese	lij^ne^se
lijtere	lij^te^re
loebpele	loeb^pe^le
loedtehke	loed^teh^ke
loeptjehke	loep^tjeh^ke
loestege	loes^te^ge
lohkeme	loh^ke^me
lohkije	loh^ki^je
lovrene	lov^re^ne
lovrenje	lov^re^nje
lovtene	lov^te^ne
luabtetje	luab^te^tje
luehkeme	lueh^ke^me
luejhteme	luejh^te^me
luemege	lue^me^ge
lujsege	luj^se^ge
luvsege	luv^se^ge
lyjnehke	lyj^neh^ke
lyvtere	lyv^te^re
låasije	låa^si^je
låavtege	låav^te^ge
låesuve	låe^su^ve
læjjone	læj^jo^ne
læjnetje	læj^ne^tje
lïegkese	lïeg^ke^se
lïereme	lïe^re^me
lïestege	lïes^te^ge
lïhtsege	lïh^tse^ge
lïhtsehke	lïh^tseh^ke
lïjhtere	lïjh^te^re
lïnghkese	lïngh^ke^se
lööneme	löö^ne^me
maadtege	maad^te^ge
maadtere	maad^te^re
maaketje	maa^ke^tje
maaksove	maak^so^ve
maalese	maa^le^se
maastere	maas^te^re
maavnese	maav^ne^se
maksove	mak^so^ve
mammone	mam^mo^ne
martere	mar^te^re
massere	mas^se^re
meadtehke	mead^teh^ke
mearohke	mea^roh^ke
measege	mea^se^ge
measehke	mea^seh^ke
measetje	mea^se^tje
meedije	mee^di^je
meessege	mees^se^ge
meetere	mee^te^re
mekseme	mek^se^me
mierehke	mie^reh^ke
miesehke	mie^seh^ke
mietene	mie^te^ne
mijnuse	mij^nu^se
minngehke	min^ngeh^ke
moehrele	moeh^re^le
moehtege	moeh^te^ge
moenehke	moe^neh^ke
moenehtse	moe^neh^tse
moetele	moe^te^le
mohtege	moh^te^ge
mojhtese	mojh^te^se
moltjere	mol^tje^re
morhteske	morh^tes^ke
morrele	mor^re^le
moskese	mos^ke^se
moskuse	mos^ku^se
moskuve	mos^ku^ve
mosnege	mos^ne^ge
mossere	mos^se^re
motovre	mo^tov^re
movrege	mov^re^ge
muadtehke	muad^teh^ke
muadtese	muad^te^se
muarhketje	muarh^ke^tje
muarjetje	muar^je^tje
mudtere	mud^te^re
muekere	mue^ke^re
mujhtehtje	mujh^teh^tje
mujhteme	mujh^te^me
murhkije	murh^ki^je
murhteske	murh^tes^ke
museeume	mu^seeu^me
muvmije	muv^mi^je
myssetje	mys^se^tje
mådtsohke	måd^tsoh^ke
måjvetje	måj^ve^tje
måssere	mås^se^re
måvhkese	måvh^ke^se
mååjsetje	mååj^se^tje
mååktege	mååk^te^ge
mååretje	måå^re^tje
mænngele	mæn^nge^le
mænngole	mæn^ngo^le
mïelehke	mïe^leh^ke
mïelkese	mïel^ke^se
mïerehke	mïe^reh^ke
mïestere	mïes^te^re
mïetege	mïe^te^ge
mïetele	mïe^te^le
mïevhkese	mïevh^ke^se
mönstere	mön^ste^re
mööbele	möö^be^le
möölege	möö^le^ge
naalehke	naa^leh^ke
naapere	naa^pe^re
naarene	naa^re^ne
nabletje	nab^le^tje
nahkere	nah^ke^re
najpetje	naj^pe^tje
navsere	nav^se^re
nazije	na^zi^je
nealketje	neal^ke^tje
neapede	nea^pe^de
neapere	nea^pe^re
neastetje	neas^te^tje
nebnije	neb^ni^je
neehlege	neeh^le^ge
nejlihke	nej^lih^ke
nentjeme	nen^tje^me
nestore	nes^to^re
niehkere	nieh^ke^re
nieskeme	nies^ke^me
nietsege	nie^tse^ge
nihtjele	nih^tje^le
njaalkese	njaal^ke^se
njaalketje	njaal^ke^tje
njaareme	njaa^re^me
njahpede	njah^pe^de
njalhtehke	njalh^teh^ke
njalhtjehke	njalht^jeh^ke
njammehke	njam^meh^ke
njeamehke	njea^meh^ke
njeeruve	njee^ru^ve
njimkese	njim^ke^se
njoektjeme	njoek^tje^me
njoevege	njoe^ve^ge
njoeveme	njoe^ve^me
njohtele	njoh^te^le
njonnjele	njon^nje^le
njuanetje	njua^ne^tje
njuenehke	njue^neh^ke
njyhtele	njyh^te^le
njyssetje	njys^se^tje
njåemele	njåe^me^le
njålhtjehke	njålht^jeh^ke
njålhtjohke	njålht^joh^ke
njïdtjele	njïd^tje^le
njïetsege	njïe^tse^ge
njïevede	njïe^ve^de
noffele	nof^fe^le
noljehke	no^ljeh^ke
nommere	nom^me^re
novhtehke	novh^teh^ke
novpele	nov^pe^le
novsege	nov^se^ge
novsehke	nov^seh^ke
nuljehke	nu^ljeh^ke
nummere	num^me^re
nyhtele	nyh^te^le
nyjsene	nyj^se^ne
nyöjtetje	nyöj^te^tje
nåajtoje	nåaj^to^je
nåajtome	nåaj^to^me
nåarvetje	nåar^ve^tje
nåhkeme	nåh^ke^me
nåhkere	nåh^ke^re
nåhpehke	nåh^peh^ke
nåhpohke	nåh^poh^ke
nåvsere	nåv^se^re
nåådese	nåå^de^se
nååletje	nåå^le^tje
nåårese	nåå^re^se
næhkere	næh^ke^re
nïddese	nïd^de^se
nïejtetje	nïej^te^tje
nïmmere	nïm^me^re
nïrrese	nïr^re^se
obletje	ob^le^tje
ohkene	oh^ke^ne
ohtseme	oh^tse^me
ohtsije	oh^tsi^je
oksehke	ok^seh^ke
oktober	ok^to^ber
olketje	ol^ke^tje
ollehke	ol^leh^ke
olleme	ol^le^me
ollene	ol^le^ne
ollenje	ol^le^nje
orgije	or^gi^je
ostehke	os^teh^ke
otnege	ot^ne^ge
otnjege	ot^nje^ge
paehpere	paeh^pe^re
paerone	pae^ro^ne
passere	pas^se^re
pastore	pas^to^re
pillere	pil^le^re
plaajhkije	plaajh^ki^je
plaantege	plaan^te^ge
plaaveme	plaa^ve^me
planktone	plank^to^ne
pleentege	pleen^te^ge
pleenume	plee^nu^me
plierehke	plie^reh^ke
plomstere	plom^ste^re
pluavetje	plua^ve^tje
plåamstere	plåam^ste^re
plæjjohke	plæj^joh^ke
plïehtjege	plïeh^tje^ge
plïejhkehke	plïejh^keh^ke
plïerehke	plïe^reh^ke
praadtetje	praad^te^tje
praahkehke	praah^keh^ke
praahkese	praah^ke^se
praarehke	praa^reh^ke
prarrohke	prar^roh^ke
preavetje	prea^ve^tje
preehkehke	preeh^keh^ke
preemije	pree^mi^je
preesense	pree^sen^se
proffele	prof^fe^le
provdese	prov^de^se
provkome	prov^ko^me
provnege	prov^ne^ge
provrese	prov^re^se
pruvrese	pruv^re^se
prïhtjege	prïh^tje^ge
prïhtjhvoessetje	prïhtjhvoes^se^tje
purpure	pur^pu^re
påassene	påas^se^ne
pååjketje	pååj^ke^tje
pæhpere	pæh^pe^re
raajese	raa^je^se
raajhpese	raajh^pe^se
raajrese	raaj^re^se
raajtere	raaj^te^re
raajtese	raaj^te^se
raampele	raam^pe^le
raastege	raas^te^ge
raavmere	raav^me^re
raavnije	raav^ni^je
radtjehke	rad^tjeh^ke
raedtehke	raed^teh^ke
raerhkije	raerh^ki^je
raerije	rae^ri^je
ragkenje	rag^ke^nje
reaktore	reak^to^re
reavere	rea^ve^re
reektehtse	reek^teh^tse
reepesje	ree^pe^sje
reereme	ree^re^me
reeseme	ree^se^me
rehkere	reh^ke^re
rektore	rek^to^re
riehpene	rieh^pe^ne
riektege	riek^te^ge
rijrenje	rij^re^nje
rijrije	rij^ri^je
ringsije	ring^si^je
ritneme	rit^ne^me
roejese	roe^je^se
roepsede	roep^se^de
rohtjehke	roh^tjeh^ke
rosseme	ros^se^me
rotjkede	rotj^ke^de
rovhtere	rovh^te^re
rovhtetje	rovh^te^tje
rovkije	rov^ki^je
rovmere	rov^me^re
rovtore	rov^to^re
ruavere	rua^ve^re
ruerhkeme	ruerh^ke^me
ruvveske	ruv^ves^ke
ryöknege	ryök^ne^ge
ryökneme	ryök^ne^me
råahtove	råah^to^ve
råantjehke	råan^tjeh^ke
råaskome	råas^ko^me
råateme	råa^te^me
råeteme	råe^te^me
råtnohke	råt^noh^ke
råvmere	råv^me^re
rååfetje	råå^fe^tje
rååjretje	rååj^re^tje
rååkngetje	rååk^nge^tje
rååretje	råå^re^tje
råårhkesje	råårh^ke^sje
rååvkese	rååv^ke^se
rååvketje	rååv^ke^tje
ræpmere	ræp^me^re
ræssjetje	ræs^sje^tje
rïeksege	rïek^se^ge
rïektege	rïek^te^ge
rïektese	rïek^te^se
rïesege	rïe^se^ge
rïeseme	rïe^se^me
rïevtege	rïev^te^ge
rïhkede	rïh^ke^de
rïpmije	rïp^mi^je
saabate	saa^ba^te
saadkeme	saad^ke^me
saadtege	saad^te^ge
saadteske	saad^tes^ke
saajkere	saaj^ke^re
saalehte	saa^leh^te
saaleme	saa^le^me
saalhtetje	saalh^te^tje
saarkelme	saar^kel^me
saarkeme	saar^ke^me
saavetje	saa^ve^tje
sadtege	sad^te^ge
sadtere	sad^te^re
sadtetje	sad^te^tje
saedkeme	saed^ke^me
saejrehke	saej^reh^ke
saeleme	sae^le^me
saenjehtje	sae^njeh^tje
saenteme	saen^te^me
saevege	sae^ve^ge
saksere	sak^se^re
sampele	sam^pe^le
sampere	sam^pe^re
sapmere	sap^me^re
sarvehke	sar^veh^ke
seareme	sea^re^me
searome	sea^ro^me
seatere	sea^te^re
seenije	see^ni^je
seerije	see^ri^je
seevehke	see^veh^ke
sektore	sek^to^re
senije	se^ni^je
sensore	sen^so^re
serbere	ser^be^re
servere	ser^ve^re
siejpehke	siej^peh^ke
sieptjeme	siep^tje^me
siffere	sif^fe^re
sigkese	sig^ke^se
sihtege	sih^te^ge
sijjeme	sij^je^me
sinnjele	sin^nje^le
sirhkuse	sirh^ku^se
sisnjele	sis^nje^le
sisvege	sis^ve^ge
sjampove	sjam^po^ve
sjangere	sja^nge^re
sjannjele	sjan^nje^le
sjapmere	sjap^me^re
sjielege	sjie^le^ge
sjiereme	sjie^re^me
sjiffere	sjif^fe^re
sjinnjele	sjin^nje^le
sjisjnjele	sjisj^nje^le
sjorjehke	sjor^jeh^ke
sjuvvese	sjuv^ve^se
sjuvvesje	sjuv^ve^sje
sjyjjehke	sjyj^jeh^ke
skaadtehke	skaad^teh^ke
skaadtjere	skaad^tje^re
skaahkele	skaah^ke^le
skaapetje	skaa^pe^tje
skaarjehke	skaar^jeh^ke
skaarjohke	skaar^joh^ke
skaavtege	skaav^te^ge
skadtere	skad^te^re
skaenjehke	skae^njeh^ke
skeajtere	skeaj^te^re
skearrehke	skear^reh^ke
skeatetje	skea^te^tje
skobtjele	skob^tje^le
skoeltere	skoel^te^re
skoetehke	skoe^teh^ke
skohpese	skoh^pe^se
skohtele	skoh^te^le
skomtjele	skom^tje^le
skopmehke	skop^meh^ke
skorpetje	skor^pe^tje
skovhtere	skovh^te^re
skovleme	skov^le^me
skovrese	skov^re^se
skovtere	skov^te^re
skraadtere	skraad^te^re
skraapenje	skraa^pe^nje
skreadtere	skread^te^re
skromhkese	skromh^ke^se
skrååjrehke	skrååj^reh^ke
skuahtere	skuah^te^re
skubpehke	skub^peh^ke
skuvtere	skuv^te^re
skygkere	skyg^ke^re
skylleme	skyl^le^me
skyölpetje	skyöl^pe^tje
skåakngetje	skåak^nge^tje
skåarrege	skåar^re^ge
skååvvetje	skååv^ve^tje
skæhkere	skæh^ke^re
skïejtere	skïej^te^re
skïemtjije	skïem^tji^je
skïenghkere	skïengh^ke^re
skïerede	skïe^re^de
skïetetje	skïe^te^tje
skïhtere	skïh^te^re
slaadtere	slaad^te^re
slaampere	slaam^pe^re
slaavhkese	slaavh^ke^se
sleemege	slee^me^ge
slibnehke	slib^neh^ke
slibnjehke	slib^njeh^ke
sliehtehke	slieh^teh^ke
slijjege	slij^je^ge
sliktehke	slik^teh^ke
slotjkese	slotj^ke^se
sluatere	slua^te^re
sluemege	slue^me^ge
slyöktehke	slyök^teh^ke
slåavege	slåa^ve^ge
slåeptjehke	slåep^tjeh^ke
slåevede	slåe^ve^de
slïbnjehke	slïb^njeh^ke
slïedtetje	slïed^te^tje
slïehtehke	slïeh^teh^ke
slïejhtege	slïejh^te^ge
smaerehtse	smae^reh^tse
smaevele	smae^ve^le
smeelege	smee^le^ge
smeeleme	smee^le^me
snaaltije	snaal^ti^je
snaaskere	snaas^ke^re
snadderge	snad^der^ge
snjåajpele	snjåaj^pe^le
snjååjpele	snjååj^pe^le
snuhtere	snuh^te^re
snåvrehke	snåv^reh^ke
snæhkere	snæh^ke^re
snæhperde	snæh^per^de
snïjrehke	snïj^reh^ke
soegkehke	soeg^keh^ke
soehpenje	soeh^pe^nje
soejkesje	soej^ke^sje
soejvene	soej^ve^ne
soenehke	soe^neh^ke
soermese	soer^me^se
soetele	soe^te^le
sohkere	soh^ke^re
soptsese	sop^tse^se
sorreske	sor^res^ke
sovkije	sov^ki^je
sovvene	sov^ve^ne
spaagkohke	spaag^koh^ke
spaajhtere	spaajh^te^re
spaanese	spaa^ne^se
spealije	spea^li^je
speejjele	speej^je^le
spermije	sper^mi^je
spoejege	spoe^je^ge
spoerjehke	spoer^jeh^ke
sponsore	spon^so^re
spæjhkere	spæjh^ke^re
staakene	staa^ke^ne
staatuse	staa^tu^se
stanteme	stan^te^me
steebnege	steeb^ne^ge
stilleme	stil^le^me
stodtetje	stod^te^tje
stratjketje	stratj^ke^tje
streavere	strea^ve^re
stuehkere	stueh^ke^re
stuhtjetje	stuh^tje^tje
stuvdije	stuv^di^je
stååpelge	ståå^pel^ge
suehpede	sueh^pe^de
suenjere	sue^nje^re
sueptjehke	suep^tjeh^ke
sujhtije	sujh^ti^je
suvhtije	suvh^ti^je
suvtije	suv^ti^je
svaajhtere	svaajh^te^re
svaalhtese	svaalh^te^se
svaalije	svaa^li^je
svaejlehke	svaej^leh^ke
svaelvere	svael^ve^re
svalkere	sval^ke^re
svelmere	svel^me^re
svikteme	svik^te^me
svintjehke	svin^tjeh^ke
svirrege	svir^re^ge
sviskere	svis^ke^re
svyjrege	svyj^re^ge
svååjpele	svååj^pe^le
svïjrege	svïj^re^ge
sygkele	syg^ke^le
syjhtede	syjh^te^de
syjkele	syj^ke^le
syjnetje	syj^ne^tje
sykluse	sy^klu^se
syölmege	syöl^me^ge
syölmehke	syöl^meh^ke
såajere	såa^je^re
såaketje	såa^ke^tje
sådtere	såd^te^re
såehpele	såeh^pe^le
såekehke	såe^keh^ke
såeleme	såe^le^me
såjhtere	såjh^te^re
såvhtere	såvh^te^re
såågkese	sååg^ke^se
sååhkehtje	sååh^keh^tje
sååhkere	sååh^ke^re
sååhpesje	sååh^pe^sje
sååjhtese	sååjh^te^se
sååjvele	sååj^ve^le
sååkehtje	såå^keh^tje
sååketje	såå^ke^tje
sæjlome	sæj^lo^me
sæjrobpe	sæj^rob^pe
sïbjege	sïb^je^ge
sïejpege	sïej^pe^ge
sïeptege	sïep^te^ge
sïesele	sïe^se^le
sïetele	sïe^te^le
sïetere	sïe^te^re
sïhtege	sïh^te^ge
sïjhtege	sïjh^te^ge
sïjhtjege	sïjht^je^ge
sööketje	söö^ke^tje
söövdeske	sööv^des^ke
taadtere	taad^te^re
taatere	taa^te^re
talkije	tal^ki^je
tallerhke	tal^lerh^ke
teegele	tee^ge^le
teellere	teel^le^re
tempele	tem^pe^le
tennise	ten^ni^se
terrore	ter^ro^re
tijkere	tij^ke^re
tjaasmege	tjaas^me^ge
tjaatsege	tjaa^tse^ge
tjaatsetje	tjaa^tse^tje
tjaavtese	tjaav^te^se
tjaeleme	tjae^le^me
tjaelije	tjae^li^je
tjagkere	tjag^ke^re
tjahkere	tjah^ke^re
tjahteme	tjah^te^me
tjalleme	tjal^le^me
tjalmeme	tjal^me^me
tjalmese	tjal^me^se
tjantsehke	tjan^tseh^ke
tjeakohke	tjea^koh^ke
tjeallere	tjeal^le^re
tjeanere	tjea^ne^re
tjeapohke	tjea^poh^ke
tjearmehke	tjear^meh^ke
tjearone	tjea^ro^ne
tjeatere	tjea^te^re
tjeedtege	tjeed^te^ge
tjeelhtjeme	tjeelht^je^me
tjeengkere	tjeeng^ke^re
tjeerege	tjee^re^ge
tjehkere	tjeh^ke^re
tjehtjere	tjeh^tje^re
tjengkere	tjeng^ke^re
tjerkehke	tjer^keh^ke
tjerkeske	tjer^kes^ke
tjiehtjere	tjieh^tje^re
tjiepseme	tjiep^se^me
tjietsuve	tjie^tsu^ve
tjihtese	tjih^te^se
tjillege	tjil^le^ge
tjimkeme	tjim^ke^me
tjintjege	tjin^tje^ge
tjintjere	tjin^tje^re
tjirkije	tjir^ki^je
tjirrehke	tjir^reh^ke
tjivvelge	tjiv^vel^ge
tjoegkeme	tjoeg^ke^me
tjoevkese	tjoev^ke^se
tjoevtenje	tjoev^te^nje
tjohpehke	tjoh^peh^ke
tjohpese	tjoh^pe^se
tjohpetje	tjoh^pe^tje
tjohtese	tjoh^te^se
tjolhtere	tjolh^te^re
tjolkeme	tjol^ke^me
tjomhpetje	tjomh^pe^tje
tjompere	tjom^pe^re
tjongkere	tjong^ke^re
tjorrege	tjor^re^ge
tjovkese	tjov^ke^se
tjovrehke	tjov^reh^ke
tjovrese	tjov^re^se
tjovtjehke	tjov^tjeh^ke
tjuegkele	tjueg^ke^le
tjuengele	tjue^nge^le
tjuepseme	tjuep^se^me
tjuevtenje	tjuev^te^nje
tjuntsehke	tjun^tseh^ke
tjuvtjege	tjuv^tje^ge
tjuvvelge	tjuv^vel^ge
tjåagkije	tjåag^ki^je
tjåagkome	tjåag^ko^me
tjåalhtetje	tjåalh^te^tje
tjåamehtse	tjåa^meh^tse
tjåentjeme	tjåen^tje^me
tjåetjeme	tjåe^tje^me
tjåetskeme	tjåets^ke^me
tjåhkome	tjåh^ko^me
tjåågkehtje	tjååg^keh^tje
tjååtjehke	tjåå^tjeh^ke
tjååtsele	tjåå^tse^le
tjïehkele	tjïeh^ke^le
tjïehkere	tjïeh^ke^re
tjïehtjele	tjïeh^tje^le
tjïekere	tjïe^ke^re
tjïengele	tjïe^nge^le
tjïeskese	tjïes^ke^se
tjïevrege	tjïev^re^ge
tjïevtenje	tjïev^te^nje
tjïhtjege	tjïh^tje^ge
tjïjlese	tjïj^le^se
tjïjrese	tjïj^re^se
tjïntsehke	tjïn^tseh^ke
tjöönghkije	tjööngh^ki^je
tjööpseme	tjööp^se^me
tjöötjehke	tjöö^tjeh^ke
tjöötjele	tjöö^tje^le
tovsene	tov^se^ne
trablehke	trab^leh^ke
trajlere	traj^le^re
traktovre	trak^tov^re
treavkese	treav^ke^se
trååsmese	tråås^me^se
trööhnege	trööh^ne^ge
trööhtnege	trööht^ne^ge
tsaekeme	tsae^ke^me
tsagkeme	tsag^ke^me
tsagkese	tsag^ke^se
tseagkere	tseag^ke^re
tseegkeme	tseeg^ke^me
tseegkuve	tseeg^ku^ve
tsiehtsere	tsieh^tse^re
tsihtsije	tsih^tsi^je
tsohtsije	tsoh^tsi^je
tsyjhtsehke	tsyjht^seh^ke
tsåakele	tsåa^ke^le
tsåakeske	tsåa^kes^ke
tsåeptsele	tsåep^tse^le
tsïengele	tsïe^nge^le
tsööhtsere	tsööh^tse^re
tsöötsege	tsöö^tse^ge
tåallere	tåal^le^re
ulleme	ul^le^me
urrehke	ur^reh^ke
vaadese	vaa^de^se
vaadtere	vaad^te^re
vaahtere	vaah^te^re
vaajese	vaa^je^se
vaaksjome	vaak^sjo^me
vaarege	vaa^re^ge
vaarese	vaa^re^se
vaaretje	vaa^re^tje
vaarhuge	vaar^hu^ge
vaarrege	vaar^re^ge
vaarrije	vaar^ri^je
vaassere	vaas^se^re
vadtese	vad^te^se
vaedtsije	vaed^tsi^je
vaelmege	vael^me^ge
vaeltjehke	vael^tjeh^ke
vaentjele	vaen^tje^le
vaerehke	vae^reh^ke
vahkije	vah^ki^je
vahtetje	vah^te^tje
vajtele	vaj^te^le
valkese	val^ke^se
vampyjre	vam^pyj^re
varrege	var^re^ge
vasjnjetje	vasj^nje^tje
veajhtohke	veajh^toh^ke
vealmetje	veal^me^tje
vearelde	vea^rel^de
vearmetje	vear^me^tje
veartene	vear^te^ne
veasome	vea^so^me
vedtneme	vedt^ne^me
veeljeme	vee^lje^me
veelteme	veel^te^me
vektore	vek^to^re
vesjnjeske	vesj^njes^ke
vetneme	vet^ne^me
viedtehke	vied^teh^ke
vieljebe	vie^lje^be
vielpele	viel^pe^le
vielteme	viel^te^me
vierhtege	vierh^te^ge
viermehke	vier^meh^ke
vietjere	vie^tje^re
vihtenje	vih^te^nje
vijreme	vij^re^me
vijrije	vij^ri^je
voedtege	voed^te^ge
voehpealmetjh	voeh^peal^metjh
voehpije	voeh^pi^je
voejkene	voej^ke^ne
voejmehtje	voej^meh^tje
voejmese	voej^me^se
voejngese	voej^nge^se
voektenje	voek^te^nje
voektije	voek^ti^je
voelere	voe^le^re
voelese	voe^le^se
voelkove	voel^ko^ve
voemesje	voe^me^sje
voenehke	voe^neh^ke
voenjele	voe^nje^le
voepije	voe^pi^je
voerese	voe^re^se
voerpehke	voer^peh^ke
voessetje	voes^se^tje
vuanove	vua^no^ve
vuastetje	vuas^te^tje
vuejeme	vue^je^me
vuejije	vue^ji^je
vuelkeme	vuel^ke^me
vuenjele	vue^nje^le
vuenteme	vuen^te^me
vuerhkede	vuerh^ke^de
vuestehke	vues^teh^ke
vuetjije	vue^tji^je
vustije	vus^ti^je
vyjreme	vyj^re^me
vyllehke	vyl^leh^ke
vyskede	vys^ke^de
vystove	vys^to^ve
vytnetje	vyt^ne^tje
vyölkede	vyöl^ke^de
våademe	våa^de^me
våarohke	våa^roh^ke
våarome	våa^ro^me
vååjmetje	vååj^me^tje
vååjnese	vååj^ne^se
vååltese	våål^te^se
våårhketje	våårh^ke^tje
vååstege	våås^te^ge
vååtnetje	vååt^ne^tje
vædtsohke	væd^tsoh^ke
væjdere	væj^de^re
væjjere	væj^je^re
væjrere	væj^re^re
væjsehke	væj^seh^ke
væjsere	væj^se^re
vætnere	væt^ne^re
vïedtege	vïed^te^ge
vïedtere	vïed^te^re
vïekserge	vïek^ser^ge
vïektege	vïek^te^ge
vïengkere	vïeng^ke^re
vïerhtsehke	vïerht^seh^ke
vïskede	vïs^ke^de
vïskese	vïs^ke^se
vïssjehke	vïs^sjeh^ke
vïtjvege	vïtj^ve^ge
vöölehtje	vöö^leh^tje
vöönteme	vöön^te^me
walkije	wal^ki^je
åadtjije	åad^tji^je
åahpetje	åah^pe^tje
åakere	åa^ke^re
åemehke	åe^meh^ke
åerije	åe^ri^je
åerpele	åer^pe^le
åerpene	åer^pe^ne
åeruve	åe^ru^ve
ålpetje	ål^pe^tje
ångkene	ång^ke^ne
årroje	år^ro^je
åssjele	ås^sje^le
åvtehke	åv^teh^ke
ååbpere	ååb^pe^re
ååjrese	ååj^re^se
ååjretje	ååj^re^tje
ååksjetje	ååk^sje^tje
ååletje	åå^le^tje
åålije	åå^li^je
ååltetje	åål^te^tje
åårdnege	åård^ne^ge
åårpege	åår^pe^ge
ååvede	åå^ve^de
ååvere	åå^ve^re
ïedtjije	ïed^tji^je
öörnege	öör^ne^ge
