aajhtedh	aajh^tedh
aajhtsedh	aajht^sedh
aajkedh	aaj^kedh
aalhtedh	aalh^tedh
aanodh	aa^nodh
aasnedh	aas^nedh
aatedh	aa^tedh
aavjodh	aav^jodh
aavnodh	aav^nodh
abrodh	ab^rodh
aededh	ae^dedh
aejhtedh	aejh^tedh
aektedh	aek^tedh
aelkedh	ael^kedh
aeredh	ae^redh
aeskedh	aes^kedh
ajmodh	aj^modh
ajpedh	aj^pedh
ajtodh	aj^todh
ajvedh	aj^vedh
almodh	al^modh
arhkedh	arh^kedh
arhpedh	arh^pedh
arhtedh	arh^tedh
armodh	ar^modh
astedh	as^tedh
asvedh	as^vedh
atjkedh	atj^kedh
baadtedh	baad^tedh
baahtjedh	baah^tjedh
baahtsedh	baah^tsedh
baajedh	baa^jedh
baajnedh	baaj^nedh
baajskodh	baaj^skodh
baaktjedh	baak^tjedh
baalhkodh	baalh^kodh
baalkedh	baal^kedh
baartedh	baar^tedh
baatjedh	baa^tjedh
baavedh	baa^vedh
baavhkedh	baavh^kedh
baavhkodh	baavh^kodh
baavodh	baa^vodh
baavsedh	baav^sedh
baedtedh	baed^tedh
baejhtedh	baejh^tedh
baeledh	bae^ledh
baermedh	baer^medh
baetsedh	bae^tsedh
bagkedh	bag^kedh
bajkedh	baj^kedh
bajnedh	baj^nedh
baktedh	bak^tedh
balledh	bal^ledh
bankedh	ban^kedh
bansjedh	ban^sjedh
barhkedh	barh^kedh
barkedh	bar^kedh
barredh	bar^redh
barsjedh	bar^sjedh
baskedh	bas^kedh
beadtodh	bead^todh
beagkedh	beag^kedh
beamodh	bea^modh
bearhtodh	bearh^todh
beassedh	beas^sedh
beavkodh	beav^kodh
beavnedh	beav^nedh
beavnodh	beav^nodh
beedtedh	beed^tedh
beejredh	beej^redh
beelhkedh	beelh^kedh
beelhkedh	beelh^kedh
beelledh	beel^ledh
beenghkedh	beengh^kedh
beerhkedh	beerh^kedh
beerhtjedh	beerht^jedh
beerkedh	beer^kedh
bejhkedh	bejh^kedh
beltedh	bel^tedh
berkedh	ber^kedh
bertedh	ber^tedh
bestedh	bes^tedh
bidtjedh	bid^tjedh
biehtedh	bieh^tedh
biejkedh	biej^kedh
biejstedh	biej^stedh
biekedh	bie^kedh
biektjedh	biek^tjedh
bielhkedh	bielh^kedh
biermedh	bier^medh
biesmedh	bies^medh
biestedh	bies^tedh
bietskedh	biets^kedh
bievnedh	biev^nedh
bigkedh	big^kedh
bihkedh	bih^kedh
bijredh	bij^redh
biktedh	bik^tedh
binhtedh	binh^tedh
birhkedh	birh^kedh
birnjedh	bir^njedh
birredh	bir^redh
bissedh	bis^sedh
bivtedh	biv^tedh
bleentedh	bleen^tedh
bleentedh	bleen^tedh
bloggedh	blog^gedh
blutjkedh	blutj^kedh
boedtjedh	boed^tjedh
boedtsedh	boed^tsedh
boelnedh	boel^nedh
boevedh	boe^vedh
boevhredh	boevh^redh
boevnjedh	boev^njedh
boevredh	boev^redh
bohkedh	boh^kedh
bohtjedh	boh^tjedh
boltedh	bol^tedh
bonnedh	bon^nedh
borsedh	bor^sedh
borsjedh	bor^sjedh
bossedh	bos^sedh
botnjedh	bot^njedh
bovredh	bov^redh
bradtjedh	brad^tjedh
brorredh	bror^redh
buajhkedh	buajh^kedh
buddedh	bud^dedh
budtedh	bud^tedh
budtedh	bud^tedh
buektedh	buek^tedh
bueledh	bue^ledh
buhtjedh	buh^tjedh
bujredh	buj^redh
bupmedh	bup^medh
burhkedh	burh^kedh
burkedh	bur^kedh
burredh	bur^redh
bussedh	bus^sedh
butnedh	but^nedh
buvnedh	buv^nedh
buvsedh	buv^sedh
buvtedh	buv^tedh
buvvedh	buv^vedh
bygkedh	byg^kedh
byssedh	bys^sedh
bysvedh	bys^vedh
byögkedh	byög^kedh
byöredh	byö^redh
båahkodh	båah^kodh
båajhkedh	båajh^kedh
båajmodh	båaj^modh
båajvodh	båaj^vodh
båanjodh	båa^njodh
båantodh	båan^todh
båarhkodh	båarh^kodh
båarhkodh	båarh^kodh
båarkodh	båar^kodh
båarngodh	båar^ngodh
båarodh	båa^rodh
båarvedh	båar^vedh
båarvodh	båar^vodh
båatskedh	båats^kedh
båatskodh	båats^kodh
båavjodh	båav^jodh
båavkedh	båav^kedh
båavodh	båa^vodh
båavsedh	båav^sedh
båavtodh	båav^todh
bådtjodh	båd^tjodh
båedtsedh	båed^tsedh
båeltedh	båel^tedh
båetedh	båe^tedh
båjjodh	båj^jodh
bårredh	bår^redh
bårsedh	bår^sedh
bårtedh	bår^tedh
båssodh	bås^sodh
båtnodh	båt^nodh
båvsodh	båv^sodh
bååhkedh	bååh^kedh
bååjhtedh	bååjh^tedh
båålhtedh	båålh^tedh
bååvnedh	bååv^nedh
bååvsedh	bååv^sedh
bæjhkodh	bæjh^kodh
bæjkodh	bæj^kodh
bæsvodh	bæs^vodh
bïedtedh	bïed^tedh
bïegkedh	bïeg^kedh
bïejedh	bïe^jedh
bïejedh	bïe^jedh
bïepmedh	bïep^medh
bïeredh	bïe^redh
bïesedh	bïe^sedh
bïessedh	bïes^sedh
bïevledh	bïev^ledh
bïjredh	bïj^redh
bïjvedh	bïj^vedh
bïksedh	bïk^sedh
bïlledh	bïl^ledh
bïssedh	bïs^sedh
bööktjedh	böök^tjedh
bööredh	böö^redh
böörhkedh	böörh^kedh
böörkedh	böör^kedh
böötedh	böö^tedh
böötkedh	bööt^kedh
böötskedh	bööts^kedh
böövsedh	bööv^sedh
böövtedh	bööv^tedh
daablodh	daab^lodh
daahpedh	daah^pedh
daajhtodh	daajh^todh
daajkedh	daaj^kedh
daajsedh	daaj^sedh
daaktedh	daak^tedh
daamhkodh	daamh^kodh
daamkodh	daam^kodh
daamtjodh	daam^tjodh
daanhtsodh	daanht^sodh
daanjedh	daa^njedh
daantsodh	daan^tsodh
daapedh	daa^pedh
daaptjodh	daap^tjodh
daasvodh	daas^vodh
daavledh	daav^ledh
daavtjedh	daav^tjedh
dabtedh	dab^tedh
daejdedh	daej^dedh
daejredh	daej^redh
dahkedh	dah^kedh
dahkedh	dah^kedh
dahpedh	dah^pedh
dajpedh	daj^pedh
dalhkedh	dalh^kedh
dalkedh	dal^kedh
dalmedh	dal^medh
daltedh	dal^tedh
dalvedh	dal^vedh
damhkedh	damh^kedh
damhkodh	damh^kodh
damtedh	dam^tedh
dangkodh	dang^kodh
dapkedh	dap^kedh
dapmedh	dap^medh
darhkedh	darh^kedh
darhkedh	darh^kedh
darhvedh	darh^vedh
darjodh	dar^jodh
darvedh	dar^vedh
darvodh	dar^vodh
dassedh	das^sedh
davhkedh	davh^kedh
davvodh	dav^vodh
deablodh	deab^lodh
deabpodh	deab^podh
deadtjodh	dead^tjodh
deajvodh	deaj^vodh
dealodh	dea^lodh
deapmodh	deap^modh
deaptjodh	deap^tjodh
dearodh	dea^rodh
deasodh	dea^sodh
deatjkedh	deatj^kedh
deatjkodh	deatj^kodh
deatodh	dea^todh
deavhkedh	deavh^kedh
deavjodh	deav^jodh
deebledh	deeb^ledh
deebtjedh	deeb^tjedh
deejedh	dee^jedh
deektedh	deek^tedh
deelhkedh	deelh^kedh
deelledh	deel^ledh
deemedh	dee^medh
deemtjedh	deem^tjedh
deeredh	dee^redh
deerjedh	deer^jedh
deetjkedh	deetj^kedh
deevedh	dee^vedh
dibledh	dib^ledh
diedtedh	died^tedh
dietedh	die^tedh
dievhtedh	dievh^tedh
dijpedh	dij^pedh
diknedh	dik^nedh
dikngedh	dik^ngedh
dimhtedh	dimh^tedh
diphtedh	diph^tedh
diptedh	dip^tedh
dirhvedh	dirh^vedh
dirvedh	dir^vedh
ditnedh	dit^nedh
dobtedh	dob^tedh
doehpedh	doeh^pedh
doehtedh	doeh^tedh
doekedh	doe^kedh
doelmedh	doel^medh
doeltedh	doel^tedh
doengedh	doe^ngedh
doepedh	doe^pedh
doepmedh	doep^medh
doeredh	doe^redh
doerpedh	doer^pedh
doesnedh	does^nedh
doestedh	does^tedh
doksedh	dok^sedh
doksedh	dok^sedh
dolmedh	dol^medh
dolvedh	dol^vedh
domtedh	dom^tedh
dongkedh	dong^kedh
dopmedh	dop^medh
dotkedh	dot^kedh
duahpedh	duah^pedh
dubledh	dub^ledh
duedtedh	dued^tedh
duejjedh	duej^jedh
dujjedh	duj^jedh
dulmedh	dul^medh
dumhpedh	dumh^pedh
duskedh	dus^kedh
duvhtedh	duvh^tedh
duvtedh	duv^tedh
dyjmedh	dyj^medh
dyngkedh	dyng^kedh
dyödtedh	dyöd^tedh
dåajodh	dåa^jodh
dåajvodh	dåaj^vodh
dåalvodh	dåal^vodh
dåapedh	dåa^pedh
dåapodh	dåa^podh
dåarhkedh	dåarh^kedh
dåarjodh	dåar^jodh
dåarmodh	dåar^modh
dåarodh	dåa^rodh
dåasnodh	dåas^nodh
dåastodh	dåas^todh
dåavlodh	dåav^lodh
dålvodh	dål^vodh
dåvhkedh	dåvh^kedh
dåvvodh	dåv^vodh
dååjredh	dååj^redh
dæktodh	dæk^todh
dængkodh	dæng^kodh
dïebledh	dïeb^ledh
dïejkedh	dïej^kedh
dïepsedh	dïep^sedh
dïeredh	dïe^redh
dïevedh	dïe^vedh
dïjmedh	dïj^medh
dïjpedh	dïj^pedh
dïpmedh	dïp^medh
döömedh	döö^medh
dööpmedh	dööp^medh
dööskedh	döös^kedh
döövedh	döö^vedh
eadtodh	ead^todh
eajtodh	eaj^todh
earhkodh	earh^kodh
eebledh	eeb^ledh
eegedh	ee^gedh
eejhtedh	eejh^tedh
eejsedh	eej^sedh
eekedh	ee^kedh
eeledh	ee^ledh
eerjedh	eer^jedh
eerkedh	eer^kedh
eerpedh	eer^pedh
eevedh	ee^vedh
eevhredh	eevh^redh
eevtjedh	eev^tjedh
faaledh	faa^ledh
fahkedh	fah^kedh
fahkedh	fah^kedh
fahtedh	fah^tedh
fassedh	fas^sedh
fatnedh	fat^nedh
feadtedh	fead^tedh
feajlodh	feaj^lodh
fearhkedh	fearh^kedh
feavsodh	feav^sodh
feedtedh	feed^tedh
feegredh	feeg^redh
feehtedh	feeh^tedh
feeledh	fee^ledh
feelpedh	feel^pedh
feelskedh	feel^skedh
feengkedh	feeng^kedh
feeredh	fee^redh
feerhmedh	feerh^medh
feerjedh	feer^jedh
feerkedh	feer^kedh
feerpedh	feer^pedh
feevredh	feev^redh
fihkedh	fih^kedh
firhkedh	firh^kedh
firredh	fir^redh
flidtedh	flid^tedh
flijjedh	flij^jedh
flijnedh	flij^nedh
flovvedh	flov^vedh
fluhtedh	fluh^tedh
flåarodh	flåa^rodh
flööredh	flöö^redh
foersedh	foer^sedh
frarredh	frar^redh
frarrodh	frar^rodh
freemmedh	freem^medh
froddedh	frod^dedh
frorredh	fror^redh
fryöjstedh	fryöj^stedh
frårrodh	frår^rodh
frïehtedh	frïeh^tedh
frïrredh	frïr^redh
fuajhkedh	fuajh^kedh
fuakedh	fua^kedh
fulkedh	ful^kedh
fyöjledh	fyöj^ledh
fååstedh	fåås^tedh
fænkedh	fæn^kedh
færhkedh	færh^kedh
fïjnedh	fïj^nedh
fïrredh	fïr^redh
gaabledh	gaab^ledh
gaadtsedh	gaad^tsedh
gaagkedh	gaag^kedh
gaahtjedh	gaah^tjedh
gaajedh	gaa^jedh
gaajodh	gaa^jodh
gaajtedh	gaaj^tedh
gaajtsodh	gaaj^tsodh
gaaledh	gaa^ledh
gaalkedh	gaal^kedh
gaalnedh	gaal^nedh
gaaredh	gaa^redh
gaarhkedh	gaarh^kedh
gaarhtedh	gaarh^tedh
gaarhtodh	gaarh^todh
gaarkedh	gaar^kedh
gaartedh	gaar^tedh
gaatjedh	gaa^tjedh
gaatodh	gaa^todh
gaavedh	gaa^vedh
gaavnedh	gaav^nedh
gabkedh	gab^kedh
gabredh	gab^redh
gabrodh	gab^rodh
gabtedh	gab^tedh
gadtjedh	gad^tjedh
gadtsedh	gad^tsedh
gaegkedh	gaeg^kedh
gaektjedh	gaek^tjedh
gaeledh	gae^ledh
gaerhtedh	gaerh^tedh
gaetskedh	gaets^kedh
gahkedh	gah^kedh
gahkodh	gah^kodh
gahpedh	gah^pedh
gahtjedh	gah^tjedh
gajhkedh	gajh^kedh
gajhkodh	gajh^kodh
gajjedh	gaj^jedh
gajkedh	gaj^kedh
gajrodh	gaj^rodh
gajvedh	gaj^vedh
galhkedh	galh^kedh
galkedh	gal^kedh
gamhpedh	gamh^pedh
gamkedh	gam^kedh
gapsjedh	gap^sjedh
gaptjedh	gap^tjedh
garhpedh	garh^pedh
garkedh	gar^kedh
garredh	gar^redh
garvodh	gar^vodh
gasjnedh	gasj^nedh
gaskedh	gas^kedh
gasnedh	gas^nedh
gatskedh	gats^kedh
gavtjedh	gav^tjedh
geafodh	gea^fodh
geahpodh	geah^podh
geahtjodh	geah^tjodh
geajkodh	geaj^kodh
geallodh	geal^lodh
geapedh	gea^pedh
gearodh	gea^rodh
geartedh	gear^tedh
geartodh	gear^todh
geatskodh	geats^kodh
geavodh	gea^vodh
gedtedh	ged^tedh
geehledh	geeh^ledh
geehpedh	geeh^pedh
geehtedh	geeh^tedh
geejvedh	geej^vedh
geelkedh	geel^kedh
geenedh	gee^nedh
geepedh	gee^pedh
geeredh	gee^redh
geerjedh	geer^jedh
geerkedh	geer^kedh
geervedh	geer^vedh
geesnjedh	gees^njedh
geevedh	gee^vedh
geevledh	geev^ledh
geevsedh	geev^sedh
geevtedh	geev^tedh
gelmedh	gel^medh
geltedh	gel^tedh
gepsedh	gep^sedh
gervedh	ger^vedh
gesjnedh	gesj^nedh
gesnedh	ges^nedh
gibledh	gib^ledh
gibredh	gib^redh
gieltedh	giel^tedh
giermedh	gier^medh
giesedh	gie^sedh
gihtjedh	gih^tjedh
gijhnedh	gijh^nedh
gijhtedh	gijh^tedh
giktedh	gik^tedh
gilhkedh	gilh^kedh
gilledh	gil^ledh
giltedh	gil^tedh
gimhkedh	gimh^kedh
gipsedh	gip^sedh
girhkedh	girh^kedh
girmedh	gir^medh
girtedh	gir^tedh
girvedh	gir^vedh
gisjnedh	gisj^nedh
gitnedh	git^nedh
givsedh	giv^sedh
givvedh	giv^vedh
goegkedh	goeg^kedh
goehpedh	goeh^pedh
goejedh	goe^jedh
goejhkedh	goejh^kedh
goekedh	goe^kedh
goepedh	goe^pedh
goepmedh	goep^medh
goeredh	goe^redh
goersedh	goer^sedh
goesngedh	goes^ngedh
goetsedh	goe^tsedh
goevedh	goe^vedh
goevhredh	goevh^redh
goevledh	goev^ledh
goevledh	goev^ledh
gohpedh	goh^pedh
gojredh	goj^redh
gopmedh	gop^medh
gosnedh	gos^nedh
gossedh	gos^sedh
govledh	gov^ledh
govledh	gov^ledh
gualkedh	gual^kedh
guarkedh	guar^kedh
guddedh	gud^dedh
guededh	gue^dedh
guedtedh	gued^tedh
guejhtedh	guejh^tedh
guejstedh	guej^stedh
gueredh	gue^redh
gugredh	gug^redh
guhpedh	guh^pedh
guhtjedh	guh^tjedh
guhtsedh	guh^tsedh
gujredh	guj^redh
gumhpedh	gumh^pedh
gurhkedh	gurh^kedh
gurkedh	gur^kedh
gurredh	gur^redh
gutnedh	gut^nedh
guvsedh	guv^sedh
gyjmedh	gyj^medh
gyölledh	gyöl^ledh
gyöntedh	gyön^tedh
gyösedh	gyö^sedh
gåahtsedh	gåah^tsedh
gåajhkodh	gåajh^kodh
gåajpodh	gåaj^podh
gåajvodh	gåaj^vodh
gåaktjodh	gåak^tjodh
gåaljodh	gåa^ljodh
gåalnedh	gåal^nedh
gåalodh	gåa^lodh
gåarjodh	gåar^jodh
gåarmodh	gåar^modh
gåarodh	gåa^rodh
gåarpodh	gåar^podh
gåarsodh	gåar^sodh
gåartodh	gåar^todh
gåaskodh	gåas^kodh
gåassodh	gåas^sodh
gåatodh	gåa^todh
gåavhkodh	gåavh^kodh
gåavodh	gåa^vodh
gåejstedh	gåej^stedh
gåertedh	gåer^tedh
gåglodh	gåg^lodh
gåhpodh	gåh^podh
gåhtjodh	gåh^tjodh
gåjkedh	gåj^kedh
gålhpodh	gålh^podh
gårredh	går^redh
gårrodh	går^rodh
gårvodh	går^vodh
gåtjkodh	gåtj^kodh
gåvnjodh	gåv^njodh
gåvtjedh	gåv^tjedh
gåvtjedh	gåv^tjedh
gæbpodh	gæb^podh
gæhpodh	gæh^podh
gæhtjodh	gæh^tjodh
gæhtsodh	gæh^tsodh
gæljodh	gæ^ljodh
gælpodh	gæl^podh
gæmhpodh	gæmh^podh
gærrodh	gær^rodh
gæssodh	gæs^sodh
gætjkodh	gætj^kodh
gætskodh	gæts^kodh
gævnjodh	gæv^njodh
gævtsodh	gæv^tsodh
gïbjedh	gïb^jedh
gïebledh	gïeb^ledh
gïebredh	gïeb^redh
gïehtjedh	gïeh^tjedh
gïejkedh	gïej^kedh
gïeksjedh	gïek^sjedh
gïeledh	gïe^ledh
gïertedh	gïer^tedh
gïesedh	gïe^sedh
gïjhtsedh	gïjht^sedh
gïjjedh	gïj^jedh
gïjkedh	gïj^kedh
gïkngedh	gïk^ngedh
gïlledh	gïl^ledh
gïrmedh	gïr^medh
gïrredh	gïr^redh
gööhnedh	gööh^nedh
gööledh	göö^ledh
göölvedh	gööl^vedh
gööptsedh	gööp^tsedh
göösjnedh	göösj^nedh
göötedh	göö^tedh
göövtedh	gööv^tedh
haadtjedh	haad^tjedh
haajedh	haa^jedh
haalvedh	haal^vedh
haanodh	haa^nodh
haaredh	haa^redh
haasedh	haa^sedh
haavhkodh	haavh^kodh
haavjodh	haav^jodh
haestedh	haes^tedh
hajkedh	haj^kedh
hajkodh	haj^kodh
hamhkodh	hamh^kodh
hapkedh	hap^kedh
harhkedh	harh^kedh
harredh	har^redh
hatsvedh	hats^vedh
heajjodh	heaj^jodh
healhkedh	healh^kedh
heantedh	hean^tedh
heaptodh	heap^todh
hearpedh	hear^pedh
hearvedh	hear^vedh
heededh	hee^dedh
heehkedh	heeh^kedh
heeledh	hee^ledh
heelsedh	heel^sedh
heepsedh	heep^sedh
heeptedh	heep^tedh
heeredh	hee^redh
heerredh	heer^redh
heesedh	hee^sedh
heevedh	hee^vedh
heevedh	hee^vedh
hepsedh	hep^sedh
hiejhtedh	hiejh^tedh
hievedh	hie^vedh
hihpedh	hih^pedh
hirredh	hir^redh
hohkedh	hoh^kedh
hohtjedh	hoh^tjedh
hojjedh	hoj^jedh
hoksedh	hok^sedh
hopsedh	hop^sedh
huhtedh	huh^tedh
hujjedh	huj^jedh
huksedh	huk^sedh
huktjedh	huk^tjedh
hulkedh	hul^kedh
hulvedh	hul^vedh
hurvedh	hur^vedh
huskedh	hus^kedh
hutskedh	huts^kedh
huvnjedh	huv^njedh
hyövedh	hyö^vedh
håagkodh	håag^kodh
håajpodh	håaj^podh
håajsodh	håaj^sodh
håakodh	håa^kodh
håaledh	håa^ledh
håalodh	håa^lodh
håanedh	håa^nedh
håarkodh	håar^kodh
håasedh	håa^sedh
håasodh	håa^sodh
håatjedh	håa^tjedh
håjjedh	håj^jedh
håjjedh	håj^jedh
håjnodh	håj^nodh
hååkedh	håå^kedh
hïemedh	hïe^medh
hïerpedh	hïer^pedh
hïetedh	hïe^tedh
hïnnedh	hïn^nedh
hïrredh	hïr^redh
hïspedh	hïs^pedh
hööhkedh	hööh^kedh
hööltedh	hööl^tedh
hööptedh	hööp^tedh
iedtedh	ied^tedh
iehtsedh	ieh^tsedh
ientedh	ien^tedh
iermedh	ier^medh
iernedh	ier^nedh
illedh	il^ledh
irhkedh	irh^kedh
jaadtedh	jaad^tedh
jaaskedh	jaas^kedh
jaavhkedh	jaavh^kedh
jabpedh	jab^pedh
jaefedh	jae^fedh
jaehkedh	jaeh^kedh
jaeltedh	jael^tedh
jaemedh	jae^medh
jaeptedh	jaep^tedh
jaertedh	jaer^tedh
jagkedh	jag^kedh
jahtsedh	jah^tsedh
jakngedh	jak^ngedh
jaksedh	jak^sedh
jamhkedh	jamh^kedh
janhkedh	janh^kedh
japmedh	jap^medh
jarkedh	jar^kedh
jarredh	jar^redh
jaskedh	jas^kedh
jaskodh	jas^kodh
jatnedh	jat^nedh
jatskodh	jats^kodh
javsodh	jav^sodh
jeajodh	jea^jodh
jeakedh	jea^kedh
jealodh	jea^lodh
jeangodh	jea^ngodh
jearedh	jea^redh
jeavodh	jea^vodh
jeedtedh	jeed^tedh
jeeredh	jee^redh
jeevedh	jee^vedh
jehtsedh	jeh^tsedh
jemkedh	jem^kedh
jestedh	jes^tedh
jidtedh	jid^tedh
jiehtedh	jieh^tedh
jiejedh	jie^jedh
jiekedh	jie^kedh
jieledh	jie^ledh
jihtsedh	jih^tsedh
jijhtedh	jijh^tedh
jimhkedh	jimh^kedh
jitnedh	jit^nedh
joejkedh	joej^kedh
joengedh	joe^ngedh
joevsedh	joev^sedh
jogledh	jog^ledh
jogledh	jog^ledh
jolkedh	jol^kedh
jovhtsedh	jovht^sedh
jovkedh	jov^kedh
jovkedh	jov^kedh
jovredh	jov^redh
jovsedh	jov^sedh
juedtedh	jued^tedh
juekedh	jue^kedh
jugnedh	jug^nedh
juhtedh	juh^tedh
jurjedh	jur^jedh
jutskedh	juts^kedh
juvledh	juv^ledh
juvsedh	juv^sedh
juvtjedh	juv^tjedh
jåanedh	jåa^nedh
jåangsodh	jåang^sodh
jåanodh	jåa^nodh
jåerhkedh	jåerh^kedh
jåetkedh	jået^kedh
jårredh	jår^redh
jåtskedh	jåts^kedh
jåtskedh	jåts^kedh
jåvkedh	jåv^kedh
jååkedh	jåå^kedh
jæjhkodh	jæjh^kodh
jæjrodh	jæj^rodh
jæjsodh	jæj^sodh
jælpodh	jæl^podh
jïejkedh	jïej^kedh
jïekedh	jïe^kedh
jïjledh	jïj^ledh
jööledh	jöö^ledh
jöörtedh	jöör^tedh
jööskedh	jöös^kedh
jöövedh	jöö^vedh
keebnedh	keeb^nedh
keeledh	kee^ledh
klajhpodh	klajh^podh
klajkodh	klaj^kodh
klavjodh	klav^jodh
klavkedh	klav^kedh
kleebjedh	kleeb^jedh
kleehkedh	kleeh^kedh
kleehpedh	kleeh^pedh
kleeredh	klee^redh
klienjedh	klie^njedh
klijkedh	klij^kedh
klijnedh	klij^nedh
klovhredh	klovh^redh
klyöhkedh	klyöh^kedh
klåamsodh	klåam^sodh
klåtnjodh	klåt^njodh
klåvhnjodh	klåvh^njodh
klåågedh	klåå^gedh
klååkedh	klåå^kedh
klæhtodh	klæh^todh
klæjmodh	klæj^modh
klæjvodh	klæj^vodh
klïpmedh	klïp^medh
klïssedh	klïs^sedh
kneekedh	knee^kedh
knugkedh	knug^kedh
knïhtjedh	knïh^tjedh
knïjhtjedh	knïjht^jedh
knïrredh	knïr^redh
kraakodh	kraa^kodh
kraamsodh	kraam^sodh
kraanskodh	kraan^skodh
kraantodh	kraan^todh
kraatjvedh	kraatj^vedh
kraatjvodh	kraatj^vodh
kraejedh	krae^jedh
kreedtjedh	kreed^tjedh
kreejnedh	kreej^nedh
kreemsedh	kreem^sedh
kreenghkedh	kreengh^kedh
kreeptsedh	kreep^tsedh
kreesedh	kree^sedh
kreessjedh	krees^sjedh
kreevedh	kree^vedh
krigkedh	krig^kedh
krijhtjedh	krijht^jedh
kristedh	kris^tedh
kritskedh	krits^kedh
kroedtsedh	kroed^tsedh
kroehkedh	kroeh^kedh
kroetskedh	kroets^kedh
krongkedh	krong^kedh
krovredh	krov^redh
krudhtedh	krudh^tedh
krudtedh	krud^tedh
kruhtedh	kruh^tedh
krukngedh	kruk^ngedh
krungkedh	krung^kedh
krupmedh	krup^medh
kråahkodh	kråah^kodh
kråapedh	kråa^pedh
kråapodh	kråa^podh
kråatsedh	kråa^tsedh
kråatskedh	kråats^kedh
krååmhkedh	krååmh^kedh
krååntedh	kråån^tedh
krïevedh	krïe^vedh
krïjhtjedh	krïjht^jedh
krïntedh	krïn^tedh
krïtjkedh	krïtj^kedh
krïtnedh	krït^nedh
kröödtsedh	krööd^tsedh
krööhkedh	krööh^kedh
krööhtsedh	krööh^tsedh
krööjhkedh	krööjh^kedh
kööhkedh	kööh^kedh
kööhnedh	kööh^nedh
kööksedh	köök^sedh
laabpedh	laab^pedh
laagkodh	laag^kodh
laagnedh	laag^nedh
laajjodh	laaj^jodh
laakedh	laa^kedh
laanjedh	laa^njedh
laapedh	laa^pedh
laaredh	laa^redh
laarhkodh	laarh^kodh
laatjodh	laa^tjodh
laavkedh	laav^kedh
laavkedh	laav^kedh
laavkodh	laav^kodh
laavlodh	laav^lodh
laavsedh	laav^sedh
labjedh	lab^jedh
labledh	lab^ledh
labnjodh	lab^njodh
laehpedh	laeh^pedh
laejhtedh	laejh^tedh
laekedh	lae^kedh
laektedh	laek^tedh
laeledh	lae^ledh
laemedh	lae^medh
laetjedh	lae^tjedh
lagkedh	lag^kedh
lahtedh	lah^tedh
lajjodh	laj^jodh
lajvedh	laj^vedh
laktedh	lak^tedh
laktjedh	lak^tjedh
lamkedh	lam^kedh
lankedh	lan^kedh
lapsodh	lap^sodh
laptedh	lap^tedh
laptjedh	lap^tjedh
latjkedh	latj^kedh
lavvedh	lav^vedh
leajhkodh	leajh^kodh
leamkedh	leam^kedh
leamkodh	leam^kodh
leanjedh	lea^njedh
learhkedh	learh^kedh
leatskedh	leats^kedh
leatskodh	leats^kodh
leatsodh	lea^tsodh
leavhkodh	leavh^kodh
leavkedh	leav^kedh
ledtedh	led^tedh
leebpedh	leeb^pedh
leedtedh	leed^tedh
leegedh	lee^gedh
leehkedh	leeh^kedh
leehpedh	leeh^pedh
leehtedh	leeh^tedh
leejhkedh	leejh^kedh
leejjedh	leej^jedh
leekedh	lee^kedh
leektedh	leek^tedh
leenedh	lee^nedh
leeredh	lee^redh
leesedh	lee^sedh
leessedh	lees^sedh
leevhkedh	leevh^kedh
lehtedh	leh^tedh
libkedh	lib^kedh
lidtedh	lid^tedh
liebnedh	lieb^nedh
liemnedh	liem^nedh
lietjedh	lie^tjedh
lietsedh	lie^tsedh
lijredh	lij^redh
lijsedh	lij^sedh
liktedh	lik^tedh
loejedh	loe^jedh
loejhmedh	loejh^medh
loejmedh	loej^medh
loengedh	loe^ngedh
loesedh	loe^sedh
loevedh	loe^vedh
loggedh	log^gedh
lohkedh	loh^kedh
lolledh	lol^ledh
loptedh	lop^tedh
loptedh	lop^tedh
lovvedh	lov^vedh
luebtedh	lueb^tedh
luehkedh	lueh^kedh
luejhtedh	luejh^tedh
luekedh	lue^kedh
luemkedh	luem^kedh
luemtedh	luem^tedh
luepkedh	luep^kedh
luknjedh	luk^njedh
luptedh	lup^tedh
lutnjedh	lut^njedh
luvhtedh	luvh^tedh
luvredh	luv^redh
lyhpedh	lyh^pedh
lyjhkedh	lyjh^kedh
låabpodh	låab^podh
låabtodh	låab^todh
låadtodh	låad^todh
låahtjodh	låah^tjodh
låajodh	låa^jodh
låamtodh	låam^todh
låanodh	låa^nodh
låapedh	låa^pedh
låaskodh	låas^kodh
låatjmedh	låatj^medh
låatjodh	låa^tjodh
låavkedh	låav^kedh
låeptedh	låep^tedh
låevtedh	låev^tedh
låjjodh	låj^jodh
låkngodh	låk^ngodh
låpsodh	låp^sodh
låtnodh	låt^nodh
låvnedh	låv^nedh
låvvedh	låv^vedh
lååmtedh	lååm^tedh
låånedh	låå^nedh
låånjedh	låå^njedh
læjkodh	læj^kodh
læjrodh	læj^rodh
længhkedh	længh^kedh
lïbnedh	lïb^nedh
lïedtedh	lïed^tedh
lïehtedh	lïeh^tedh
lïejpedh	lïej^pedh
lïekedh	lïe^kedh
lïengedh	lïe^ngedh
lïenjedh	lïe^njedh
lïepedh	lïe^pedh
lïeredh	lïe^redh
lïervedh	lïer^vedh
lïevhkedh	lïevh^kedh
lïgkedh	lïg^kedh
lïhpedh	lïh^pedh
lïjhtjedh	lïjht^jedh
lïjtsedh	lïj^tsedh
lööbpedh	lööb^pedh
löödtedh	lööd^tedh
löödtjedh	lööd^tjedh
löökedh	löö^kedh
löönedh	löö^nedh
lööphkedh	lööph^kedh
lööpkedh	lööp^kedh
lööptjedh	lööp^tjedh
lööskedh	löös^kedh
löövedh	löö^vedh
löövhkedh	löövh^kedh
maagredh	maag^redh
maahtsedh	maah^tsedh
maahtsodh	maah^tsodh
maarhvodh	maarh^vodh
maaskedh	maas^kedh
maaskodh	maas^kodh
maatjvodh	maatj^vodh
maatsedh	maa^tsedh
maedtedh	maed^tedh
maehtedh	maeh^tedh
maejstedh	maej^stedh
maeksedh	maek^sedh
mahtedh	mah^tedh
majkedh	maj^kedh
maktjedh	mak^tjedh
malkedh	mal^kedh
marhkedh	marh^kedh
marngedh	mar^ngedh
mastedh	mas^tedh
matkedh	mat^kedh
mavhledh	mavh^ledh
meadtodh	mead^todh
meajkedh	meaj^kedh
meajtjedh	meaj^tjedh
meaktjedh	meak^tjedh
mealtjedh	meal^tjedh
mealtjedh	meal^tjedh
mealtjodh	meal^tjodh
mearhkodh	mearh^kodh
meatjedh	mea^tjedh
meatodh	mea^todh
meavhkodh	meavh^kodh
meehtedh	meeh^tedh
meejvedh	meej^vedh
meeledh	mee^ledh
meelhtedh	meelh^tedh
meelskedh	meel^skedh
meenhtedh	meenh^tedh
meeredh	mee^redh
meerhkedh	meerh^kedh
meeskedh	mees^kedh
meevredh	meev^redh
meksedh	mek^sedh
merredh	mer^redh
miedtedh	mied^tedh
mietedh	mie^tedh
milkedh	mil^kedh
milledh	mil^ledh
milnjedh	mil^njedh
mistedh	mis^tedh
moelhnjedh	moelh^njedh
moenedh	moe^nedh
moetedh	moe^tedh
mojtsedh	moj^tsedh
molhkedh	molh^kedh
molledh	mol^ledh
mosnedh	mos^nedh
movredh	mov^redh
mudtedh	mud^tedh
mudtjedh	mud^tjedh
mudtsedh	mud^tsedh
muhkedh	muh^kedh
mujhtedh	mujh^tedh
mujvedh	muj^vedh
mulskedh	mul^skedh
munnedh	mun^nedh
murhkedh	murh^kedh
murvedh	mur^vedh
mutkedh	mut^kedh
mutskedh	muts^kedh
muvvedh	muv^vedh
måajkodh	måaj^kodh
måalledh	måal^ledh
måaltedh	måal^tedh
måarngodh	måar^ngodh
måaskedh	måas^kedh
måaskodh	måas^kodh
måasodh	måa^sodh
mådtsodh	måd^tsodh
måeltedh	måel^tedh
måertedh	måer^tedh
måjvodh	måj^vodh
målsodh	mål^sodh
mårhkedh	mårh^kedh
måsnodh	mås^nodh
måtskedh	måts^kedh
måvhkodh	måvh^kodh
mååledh	måå^ledh
måålkedh	måål^kedh
mævhkodh	mævh^kodh
mïeledh	mïe^ledh
mïerhkedh	mïerh^kedh
mïernjedh	mïer^njedh
mïetedh	mïe^tedh
mïetsedh	mïe^tsedh
mïetskedh	mïets^kedh
mïnnedh	mïn^nedh
möökedh	möö^kedh
mööledh	möö^ledh
möölhkedh	möölh^kedh
mööredh	möö^redh
möörjedh	möör^jedh
möövredh	mööv^redh
naajedh	naa^jedh
naalsedh	naal^sedh
naaskedh	naas^kedh
naatskedh	naats^kedh
naavjodh	naav^jodh
nahkedh	nah^kedh
naljodh	na^ljodh
napkedh	nap^kedh
narhtodh	narh^todh
nastedh	nas^tedh
navvedh	nav^vedh
neajhkedh	neajh^kedh
neajhkodh	neajh^kodh
neajodh	nea^jodh
nealkodh	neal^kodh
nealodh	nea^lodh
neavhtodh	neavh^todh
neebnedh	neeb^nedh
neejpedh	neej^pedh
neeledh	nee^ledh
neerredh	neer^redh
neestedh	nees^tedh
neevredh	neev^redh
negkedh	neg^kedh
nieskedh	nies^kedh
nihtedh	nih^tedh
nijjedh	nij^jedh
nijvedh	nij^vedh
niktedh	nik^tedh
nipkedh	nip^kedh
nirvedh	nir^vedh
nitskedh	nits^kedh
njaahtjodh	njaah^tjodh
njaakedh	njaa^kedh
njaalkodh	njaal^kodh
njaamedh	njaa^medh
njaarpodh	njaar^podh
njaarvedh	njaar^vedh
njaavhkodh	njaavh^kodh
njablodh	njab^lodh
njalhtjodh	njalht^jodh
njalkedh	njal^kedh
njalkodh	njal^kodh
njalledh	njal^ledh
njamkedh	njam^kedh
njamkodh	njam^kodh
njammedh	njam^medh
njarhkedh	njarh^kedh
njarhkedh	njarh^kedh
njarhvodh	njarh^vodh
njavkedh	njav^kedh
njavledh	njav^ledh
njavsodh	njav^sodh
njeajkedh	njeaj^kedh
njeajodh	njea^jodh
njeamtodh	njeam^todh
njedtsedh	njed^tsedh
njeedtsedh	njeed^tsedh
njeedvedh	njeed^vedh
njeeredh	njee^redh
njeervedh	njeer^vedh
njeetsedh	njee^tsedh
njeevhredh	njeevh^redh
njelledh	njel^ledh
njeltedh	njel^tedh
njerkedh	njer^kedh
njerredh	njer^redh
njevtedh	njev^tedh
njibledh	njib^ledh
njidtjedh	njid^tjedh
njiedtedh	njied^tedh
njieltedh	njiel^tedh
njieredh	njie^redh
njihkedh	njih^kedh
njilkedh	njil^kedh
njilledh	njil^ledh
njiltedh	njil^tedh
njoeredh	njoe^redh
njoetedh	njoe^tedh
njoetsedh	njoe^tsedh
njoevedh	njoe^vedh
njolledh	njol^ledh
njulhtjedh	njulht^jedh
njulhtjedh	njulht^jedh
njurkedh	njur^kedh
njuvtedh	njuv^tedh
njuvvedh	njuv^vedh
njylledh	njyl^ledh
njyöltedh	njyöl^tedh
njyörtedh	njyör^tedh
njåallodh	njåal^lodh
njåalodh	njåa^lodh
njåalvodh	njåal^vodh
njåamkodh	njåam^kodh
njåamodh	njåa^modh
njåaptjodh	njåap^tjodh
njåaptsodh	njåap^tsodh
njåarkodh	njåar^kodh
njåarodh	njåa^rodh
njåblodh	njåb^lodh
njålhtjodh	njålht^jodh
njårhvodh	njårh^vodh
njårkodh	njår^kodh
njæjhkodh	njæjh^kodh
njæjhkodh	njæjh^kodh
njæskodh	njæs^kodh
njïeledh	njïe^ledh
njöölledh	njööl^ledh
njöölvedh	njööl^vedh
njöömedh	njöö^medh
njööptjedh	njööp^tjedh
njööptsedh	njööp^tsedh
njööredh	njöö^redh
njöörkedh	njöör^kedh
noeledh	noe^ledh
noeredh	noe^redh
noerhkedh	noerh^kedh
noesedh	noe^sedh
noffedh	nof^fedh
nossedh	nos^sedh
novvedh	nov^vedh
nuhledh	nuh^ledh
nuhtedh	nuh^tedh
nuhtjedh	nuh^tjedh
nuktedh	nuk^tedh
nulledh	nul^ledh
nustedh	nus^tedh
nuvhledh	nuvh^ledh
nuvnedh	nuv^nedh
nuvredh	nuv^redh
nuvvedh	nuv^vedh
nyhtedh	nyh^tedh
nyjhkedh	nyjh^kedh
nyöjhkedh	nyöjh^kedh
nåajtodh	nåaj^todh
nåalodh	nåa^lodh
nåhkedh	nåh^kedh
nåljodh	nå^ljodh
nårtodh	når^todh
nåårvedh	nåår^vedh
nænnodh	næn^nodh
nærhtodh	nærh^todh
nïejhkedh	nïejh^kedh
nïejkedh	nïej^kedh
nïekedh	nïe^kedh
nïerhkedh	nïerh^kedh
nïetkedh	nïet^kedh
nïjjedh	nïj^jedh
nöödedh	nöö^dedh
nöödtedh	nööd^tedh
nöökedh	nöö^kedh
nööktedh	nöök^tedh
nööredh	nöö^redh
ohtsedh	oh^tsedh
ovledh	ov^ledh
paakedh	paa^kedh
paekedh	pae^kedh
peehkedh	peeh^kedh
peesedh	pee^sedh
plaavedh	plaa^vedh
plarhkedh	plarh^kedh
platnedh	plat^nedh
pleanjodh	plea^njodh
pleavvodh	pleav^vodh
pleehkedh	pleeh^kedh
pleehtjedh	pleeh^tjedh
pleekedh	plee^kedh
pleentedh	pleen^tedh
plienedh	plie^nedh
plijredh	plij^redh
pliktedh	plik^tedh
plirkedh	plir^kedh
plohtjedh	ploh^tjedh
plovhtjedh	plovht^jedh
plutnedh	plut^nedh
pluvhtedh	pluvh^tedh
plåahkodh	plåah^kodh
plåatjedh	plåa^tjedh
plåavedh	plåa^vedh
plåtjkedh	plåtj^kedh
plædtodh	plæd^todh
plæjhtjodh	plæjht^jodh
plærkodh	plær^kodh
plïengedh	plïe^ngedh
plïhtjedh	plïh^tjedh
plïjhtjedh	plïjht^jedh
plïjkedh	plïj^kedh
plööhkedh	plööh^kedh
praahkedh	praah^kedh
pradtjedh	prad^tjedh
pragkedh	prag^kedh
prarredh	prar^redh
preadedh	prea^dedh
preehkedh	preeh^kedh
preejhkedh	preejh^kedh
preejredh	preej^redh
protnedh	prot^nedh
provhkedh	provh^kedh
provhkedh	provh^kedh
provnedh	prov^nedh
pruvhkedh	pruvh^kedh
pruvredh	pruv^redh
pruvsedh	pruv^sedh
pruvvedh	pruv^vedh
pryjjedh	pryj^jedh
pryövedh	pryö^vedh
pråaredh	pråa^redh
pråavedh	pråa^vedh
pråtnodh	pråt^nodh
pråvhkodh	pråvh^kodh
prïesedh	prïe^sedh
prïetedh	prïe^tedh
prïetjedh	prïe^tjedh
prïjredh	prïj^redh
påaredh	påa^redh
raadtedh	raad^tedh
raajedh	raa^jedh
raajsedh	raaj^sedh
raakedh	raa^kedh
raamhpodh	raamh^podh
raanodh	raa^nodh
raavhkedh	raavh^kedh
raavkedh	raav^kedh
raavtedh	raav^tedh
rabnjodh	rab^njodh
raerhkedh	raerh^kedh
raessedh	raes^sedh
raetkedh	raet^kedh
ragkedh	rag^kedh
rahkodh	rah^kodh
rahtjedh	rah^tjedh
rapkedh	rap^kedh
raptedh	rap^tedh
rarhkodh	rarh^kodh
raskedh	ras^kedh
rassedh	ras^sedh
ravhtodh	ravh^todh
ravkedh	rav^kedh
reabnjodh	reab^njodh
reajnodh	reaj^nodh
rearvodh	rear^vodh
reavkedh	reav^kedh
rebnjedh	reb^njedh
reebledh	reeb^ledh
reededh	ree^dedh
reegkedh	reeg^kedh
reehkedh	reeh^kedh
reejnedh	reej^nedh
reejredh	reej^redh
reekedh	ree^kedh
reektedh	reek^tedh
reenskedh	reen^skedh
reeredh	ree^redh
reesedh	ree^sedh
reeskedh	rees^kedh
reesmedh	rees^medh
reetsedh	ree^tsedh
reevhtsedh	reevht^sedh
reevredh	reev^redh
reevstedh	reev^stedh
ribledh	rib^ledh
rijdedh	rij^dedh
rijdedh	rij^dedh
rijmedh	rij^medh
rijredh	rij^redh
rijredh	rij^redh
rijtedh	rij^tedh
ringkedh	ring^kedh
rintedh	rin^tedh
rintedh	rin^tedh
rirhmedh	rirh^medh
risjnedh	risj^nedh
ristedh	ris^tedh
ritnedh	rit^nedh
roehtedh	roeh^tedh
roepedh	roe^pedh
roesedh	roe^sedh
roestedh	roes^tedh
roetedh	roe^tedh
roetsedh	roe^tsedh
roevtedh	roev^tedh
rohtedh	roh^tedh
rojvedh	roj^vedh
rorvedh	ror^vedh
ruetskedh	ruets^kedh
ruhtedh	ruh^tedh
rujvedh	ruj^vedh
rutjkedh	rutj^kedh
ryöhkedh	ryöh^kedh
ryöjredh	ryöj^redh
ryökedh	ryö^kedh
ryöknedh	ryök^nedh
ryövedh	ryö^vedh
råagkodh	råag^kodh
råakedh	råa^kedh
råaknodh	råak^nodh
råakodh	råa^kodh
råamodh	råa^modh
råanedh	råa^nedh
råanjedh	råa^njedh
råanjodh	råa^njodh
råapedh	råa^pedh
råaptjodh	råap^tjodh
råarmodh	råar^modh
råaskodh	råas^kodh
råasodh	råa^sodh
råassjodh	råas^sjodh
råastodh	råas^todh
råatedh	råa^tedh
råatodh	råa^todh
råavedh	råa^vedh
råavkedh	råav^kedh
råhtjodh	råh^tjodh
rååkedh	råå^kedh
rååknedh	rååk^nedh
rååntjedh	råån^tjedh
ræhpodh	ræh^podh
ræjhkodh	ræjh^kodh
ræjmodh	ræj^modh
ræjvodh	ræj^vodh
rïddedh	rïd^dedh
rïdtjedh	rïd^tjedh
rïehkedh	rïeh^kedh
rïekedh	rïe^kedh
rïesedh	rïe^sedh
rïetjedh	rïe^tjedh
rïevedh	rïe^vedh
rïhkedh	rïh^kedh
rïhtedh	rïh^tedh
rïhtjedh	rïh^tjedh
rïjtedh	rïj^tedh
rïpmedh	rïp^medh
rïrredh	rïr^redh
rïssedh	rïs^sedh
rïssjedh	rïs^sjedh
röödtsedh	rööd^tsedh
rööhtsedh	rööh^tsedh
röökedh	röö^kedh
rööledh	röö^ledh
röönjedh	röö^njedh
röösedh	röö^sedh
röötedh	röö^tedh
röövedh	röö^vedh
röövhtsedh	röövht^sedh
saadedh	saa^dedh
saadtodh	saad^todh
saajpodh	saaj^podh
saaksedh	saak^sedh
saaksodh	saak^sodh
saaledh	saa^ledh
saaredh	saa^redh
saarkodh	saar^kodh
saarnodh	saar^nodh
saasnedh	saas^nedh
saavredh	saav^redh
saavrodh	saav^rodh
sabledh	sab^ledh
sabpedh	sab^pedh
sabtjodh	sab^tjodh
saehtedh	saeh^tedh
sagkodh	sag^kodh
saktedh	sak^tedh
salhkedh	salh^kedh
salhnjedh	salh^njedh
salkedh	sal^kedh
salnedh	sal^nedh
salnjedh	sal^njedh
salsedh	sal^sedh
samhtjodh	samht^jodh
samkedh	sam^kedh
samskedh	sam^skedh
saptodh	sap^todh
sarhkedh	sarh^kedh
sarjedh	sar^jedh
sarvedh	sar^vedh
savnjodh	sav^njodh
savredh	sav^redh
savtodh	sav^todh
seagkodh	seag^kodh
seajkodh	seaj^kodh
seakodh	sea^kodh
sealkedh	seal^kedh
sedtedh	sed^tedh
seedtedh	seed^tedh
seehpedh	seeh^pedh
seehtedh	seeh^tedh
seejedh	see^jedh
seemskedh	seem^skedh
seepedh	see^pedh
seeptjedh	seep^tjedh
seerkedh	seer^kedh
seesedh	see^sedh
sepkedh	sep^kedh
sertedh	ser^tedh
sevtedh	sev^tedh
sibjedh	sib^jedh
sierngedh	sier^ngedh
sietedh	sie^tedh
sigkedh	sig^kedh
sigledh	sig^ledh
sihkedh	sih^kedh
sijjedh	sij^jedh
sijledh	sij^ledh
sijnedh	sij^nedh
siktedh	sik^tedh
sirtedh	sir^tedh
sivvedh	siv^vedh
sjaamedh	sjaa^medh
sjaavodh	sjaa^vodh
sjaepedh	sjae^pedh
sjagkedh	sjag^kedh
sjalkedh	sjal^kedh
sjarkodh	sjar^kodh
sjattedh	sjat^tedh
sjattedh	sjat^tedh
sjeakodh	sjea^kodh
sjeapsjodh	sjeap^sjodh
sjeavnjodh	sjeav^njodh
sjeedtedh	sjeed^tedh
sjeehtedh	sjeeh^tedh
sjeemedh	sjee^medh
sjeevedh	sjee^vedh
sjeevledh	sjeev^ledh
sjijjedh	sjij^jedh
sjijsjedh	sjij^sjedh
sjilhkedh	sjilh^kedh
sjilkedh	sjil^kedh
sjoengedh	sjoe^ngedh
sjoesjedh	sjoe^sjedh
sjolledh	sjol^ledh
sjovedh	sjo^vedh
sjovvedh	sjov^vedh
sjuahkedh	sjuah^kedh
sjueksjedh	sjuek^sjedh
sjulhkedh	sjulh^kedh
sjurhtedh	sjurh^tedh
sjyövnjedh	sjyöv^njedh
sjåahkedh	sjåah^kedh
sjåajmodh	sjåaj^modh
sjåavedh	sjåa^vedh
sjåavkedh	sjåav^kedh
sjåavlodh	sjåav^lodh
sjåavodh	sjåa^vodh
sjålhkodh	sjålh^kodh
sjæjjodh	sjæj^jodh
sjïdtedh	sjïd^tedh
sjïehtedh	sjïeh^tedh
sjïelkedh	sjïel^kedh
sjïepedh	sjïe^pedh
sjöövedh	sjöö^vedh
skaanjedh	skaa^njedh
skaarhtedh	skaarh^tedh
skaarhtodh	skaarh^todh
skaavodh	skaa^vodh
skahpedh	skah^pedh
skajjedh	skaj^jedh
skajkedh	skaj^kedh
skarredh	skar^redh
skeajkedh	skeaj^kedh
skeajvedh	skeaj^vedh
skeamtjodh	skeam^tjodh
skearkedh	skear^kedh
skearmodh	skear^modh
skeehkedh	skeeh^kedh
skeejnedh	skeej^nedh
skeekedh	skee^kedh
skeeledh	skee^ledh
skeemmedh	skeem^medh
skeenedh	skee^nedh
skeenhtedh	skeenh^tedh
skeepedh	skee^pedh
skeeptedh	skeep^tedh
skeeredh	skee^redh
skeerkedh	skeer^kedh
skeevedh	skee^vedh
skerhkedh	skerh^kedh
skibledh	skib^ledh
skilhtedh	skilh^tedh
skilhtedh	skilh^tedh
skilhtjedh	skilht^jedh
skilkedh	skil^kedh
skilledh	skil^ledh
skimhkedh	skimh^kedh
skintedh	skin^tedh
skirhmedh	skirh^medh
skirredh	skir^redh
skodtedh	skod^tedh
skoebredh	skoeb^redh
skoeledh	skoe^ledh
skoerkedh	skoer^kedh
skojjedh	skoj^jedh
skorpedh	skor^pedh
skovhtjedh	skovht^jedh
skovvedh	skov^vedh
skraavrodh	skraav^rodh
skreedkedh	skreed^kedh
skreedtedh	skreed^tedh
skreejredh	skreej^redh
skreekedh	skree^kedh
skreepedh	skree^pedh
skreerkedh	skreer^kedh
skromhpedh	skromh^pedh
skromhpedh	skromh^pedh
skrumhkedh	skrumh^kedh
skryjjedh	skryj^jedh
skråanjodh	skråa^njodh
skråapodh	skråa^podh
skrïehpedh	skrïeh^pedh
skröörtedh	skröör^tedh
skröötedh	skröö^tedh
skualkedh	skual^kedh
skubpedh	skub^pedh
skueredh	skue^redh
skugledh	skug^ledh
skuhtjedh	skuh^tjedh
skultedh	skul^tedh
skunhkedh	skunh^kedh
skurhvedh	skurh^vedh
skurkedh	skur^kedh
skurkedh	skur^kedh
skurnjedh	skur^njedh
skurtedh	skur^tedh
skuvledh	skuv^ledh
skylledh	skyl^ledh
skyöredh	skyö^redh
skåarredh	skåar^redh
skåavmedh	skåav^medh
skårkedh	skår^kedh
skårtodh	skår^todh
skåvvedh	skåv^vedh
skååffedh	skååf^fedh
skåårredh	skåår^redh
skåårvedh	skåår^vedh
skæjlodh	skæj^lodh
skælkedh	skæl^kedh
skælkodh	skæl^kodh
skævkodh	skæv^kodh
skïebtjedh	skïeb^tjedh
skïelledh	skïel^ledh
skïelpedh	skïel^pedh
skïemtjedh	skïem^tjedh
skïeredh	skïe^redh
skïerkedh	skïer^kedh
skïerredh	skïer^redh
skïetjedh	skïe^tjedh
skïjledh	skïj^ledh
skööhtedh	skööh^tedh
skööpedh	sköö^pedh
skööpmedh	skööp^medh
sköörredh	sköör^redh
slaajedh	slaa^jedh
slaamedh	slaa^medh
slaamkedh	slaam^kedh
slaangkedh	slaang^kedh
slaapkedh	slaap^kedh
slaaptjedh	slaap^tjedh
slaatsodh	slaa^tsodh
slabtjodh	slab^tjodh
slajkedh	slaj^kedh
slamtjodh	slam^tjodh
slapkedh	slap^kedh
slaptjodh	slap^tjodh
slavhtjedh	slavht^jedh
sleabpodh	sleab^podh
sleapkedh	sleap^kedh
sleaptjodh	sleap^tjodh
slearodh	slea^rodh
sleebpedh	sleeb^pedh
sleegkedh	sleeg^kedh
sleehkedh	sleeh^kedh
sleehpedh	sleeh^pedh
sleehtedh	sleeh^tedh
sleejedh	slee^jedh
sleemkedh	sleem^kedh
sleengkedh	sleeng^kedh
sleepkedh	sleep^kedh
sleeptjedh	sleep^tjedh
sleeredh	slee^redh
sleervedh	sleer^vedh
sleevhkedh	sleevh^kedh
sleevvedh	sleev^vedh
sleptjedh	slep^tjedh
slibnjedh	slib^njedh
sliejhtedh	sliejh^tedh
sliemkedh	sliem^kedh
slignedh	slig^nedh
slihkedh	slih^kedh
slijhpedh	slijh^pedh
slijhtedh	slijh^tedh
slijjedh	slij^jedh
slijredh	slij^redh
sliktedh	slik^tedh
slimkedh	slim^kedh
sliptjedh	slip^tjedh
slitjkedh	slitj^kedh
slobtjedh	slob^tjedh
slogkedh	slog^kedh
slohtedh	sloh^tedh
slomtjedh	slom^tjedh
slotjkedh	slotj^kedh
slovhpedh	slovh^pedh
sluvhtedh	sluvh^tedh
sluvkedh	sluv^kedh
slyöbpedh	slyöb^pedh
slyöhpedh	slyöh^pedh
slåapedh	slåa^pedh
slåavedh	slåa^vedh
slåbtjodh	slåb^tjodh
slåmtjodh	slåm^tjodh
slåptjodh	slåp^tjodh
slæjredh	slæj^redh
slæpkedh	slæp^kedh
slæpkodh	slæp^kodh
slïebpedh	slïeb^pedh
slïmmedh	slïm^medh
slööhpedh	slööh^pedh
slööhtedh	slööh^tedh
slööjmedh	slööj^medh
slööptjedh	slööp^tjedh
smaahkodh	smaah^kodh
smaajlodh	smaaj^lodh
smaajvodh	smaaj^vodh
smealhkedh	smealh^kedh
smealhkodh	smealh^kodh
smealodh	smea^lodh
smearkodh	smear^kodh
smeejledh	smeej^ledh
smeejvedh	smeej^vedh
smeeledh	smee^ledh
smeelhkedh	smeelh^kedh
smeelnjedh	smeel^njedh
smirhtjedh	smirht^jedh
smirredh	smir^redh
smorredh	smor^redh
smovredh	smov^redh
smuadtedh	smuad^tedh
smualkedh	smual^kedh
smummedh	smum^medh
smurredh	smur^redh
smuvvedh	smuv^vedh
smyölnjedh	smyöl^njedh
smååhkedh	smååh^kedh
smïddedh	smïd^dedh
smïrredh	smïr^redh
smööledh	smöö^ledh
smöölhkedh	smöölh^kedh
snaabredh	snaab^redh
snaarhkedh	snaarh^kedh
snaarredh	snaar^redh
snarhpodh	snarh^podh
snarredh	snar^redh
sneejredh	sneej^redh
sneejtedh	sneej^tedh
sneerhkedh	sneerh^kedh
sneerredh	sneer^redh
sneertedh	sneer^tedh
snihkedh	snih^kedh
snijredh	snij^redh
snilmedh	snil^medh
snilvedh	snil^vedh
snipkedh	snip^kedh
snirredh	snir^redh
snirvedh	snir^vedh
snjaafodh	snjaa^fodh
snjadtsodh	snjad^tsodh
snjapkodh	snjap^kodh
snjeajhtodh	snjeajh^todh
snjealhkodh	snjealh^kodh
snjeelhkedh	snjeelh^kedh
snjeeredh	snjee^redh
snjidtjedh	snjid^tjedh
snjijhtjedh	snjijht^jedh
snjipkedh	snjip^kedh
snjitjkedh	snjitj^kedh
snjotjkedh	snjotj^kedh
snjuhtjedh	snjuh^tjedh
snjurmedh	snjur^medh
snjåahrodh	snjåah^rodh
snjåapedh	snjåa^pedh
snjåaredh	snjåa^redh
snjåarhtjodh	snjåarht^jodh
snjåarkedh	snjåar^kedh
snjåatjedh	snjåa^tjedh
snjæjhtjodh	snjæjht^jodh
snjæjrodh	snjæj^rodh
snjïerkedh	snjïer^kedh
snjïerpedh	snjïer^pedh
snjïjredh	snjïj^redh
snjöörkedh	snjöör^kedh
snoegkedh	snoeg^kedh
snorvedh	snor^vedh
snotskedh	snots^kedh
snovredh	snov^redh
snovsedh	snov^sedh
snuhkedh	snuh^kedh
snuhkedh	snuh^kedh
snuvhkedh	snuvh^kedh
snårhpodh	snårh^podh
snårkodh	snår^kodh
snårredh	snår^redh
snåvredh	snåv^redh
snåårhkedh	snåårh^kedh
snæjrodh	snæj^rodh
snïjredh	snïj^redh
snïrredh	snïr^redh
snööledh	snöö^ledh
snöörjedh	snöör^jedh
soebkedh	soeb^kedh
soededh	soe^dedh
soedtedh	soed^tedh
soejedh	soe^jedh
soejvedh	soej^vedh
soeksedh	soek^sedh
soelvedh	soel^vedh
soemkedh	soem^kedh
soeredh	soe^redh
soeskedh	soes^kedh
soetedh	soe^tedh
sohpedh	soh^pedh
sohtjedh	soh^tjedh
sojjedh	soj^jedh
sommedh	som^medh
sorkedh	sor^kedh
sovkedh	sov^kedh
sovkedh	sov^kedh
sovmedh	sov^medh
sovtedh	sov^tedh
spaajhkedh	spaajh^kedh
spatnedh	spat^nedh
speadtjodh	spead^tjodh
speahkodh	speah^kodh
spealhkodh	spealh^kodh
spealodh	spea^lodh
spearhkedh	spearh^kedh
speedtedh	speed^tedh
speedtjedh	speed^tjedh
speehkedh	speeh^kedh
speekedh	spee^kedh
speelhkedh	speelh^kedh
speenedh	spee^nedh
speerredh	speer^redh
spiejedh	spie^jedh
spijngedh	spij^ngedh
spiktjedh	spik^tjedh
splöönedh	splöö^nedh
splöönhkedh	splöönh^kedh
splöönskedh	splöön^skedh
spraanhtedh	spraanh^tedh
spranjkedh	spranj^kedh
sprankedh	spran^kedh
sprijnedh	sprij^nedh
sprïjnedh	sprïj^nedh
spualledh	spual^ledh
spåtnodh	spåt^nodh
spååredh	spåå^redh
spïeledh	spïe^ledh
staarpedh	staar^pedh
staavhledh	staavh^ledh
staavledh	staav^ledh
stabnjedh	stab^njedh
stanghkedh	stangh^kedh
starhkodh	starh^kodh
starnedh	star^nedh
starnodh	star^nodh
steabnodh	steab^nodh
steavhtjodh	steavht^jodh
steebnedh	steeb^nedh
steededh	stee^dedh
steegkedh	steeg^kedh
steegledh	steeg^ledh
steehpedh	steeh^pedh
steelhpedh	steelh^pedh
steelledh	steel^ledh
steempedh	steem^pedh
steentedh	steen^tedh
steeredh	stee^redh
steevredh	steev^redh
stenkedh	sten^kedh
stijredh	stij^redh
stilledh	stil^ledh
stoenedh	stoe^nedh
stoerhkedh	stoerh^kedh
stovhpedh	stovh^pedh
stovhpedh	stovh^pedh
straanjedh	straa^njedh
straavedh	straa^vedh
straavvedh	straav^vedh
stradtjedh	strad^tjedh
straenjedh	strae^njedh
stratjkodh	stratj^kodh
stravhkodh	stravh^kodh
stravkedh	strav^kedh
stravkodh	strav^kodh
stravtjedh	strav^tjedh
streadjodh	stread^jodh
streatjodh	strea^tjodh
streehkedh	streeh^kedh
streehtjedh	streeh^tjedh
strihkedh	strih^kedh
strijhpedh	strijh^pedh
strorredh	stror^redh
struvkedh	struv^kedh
stryjhkedh	stryjh^kedh
stryjhkedh	stryjh^kedh
stråapedh	stråa^pedh
stråvhkodh	stråvh^kodh
stråvkodh	stråv^kodh
strååffedh	strååf^fedh
strïenjedh	strïe^njedh
strïetjkedh	strïetj^kedh
strïjhtjedh	strïjht^jedh
strïjredh	strïj^redh
strööntedh	ströön^tedh
stulledh	stul^ledh
sturredh	stur^redh
stutnedh	stut^nedh
stuvredh	stuv^redh
styöjkedh	styöj^kedh
ståaledh	ståa^ledh
ståalodh	ståa^lodh
ståatjedh	ståa^tjedh
ståavodh	ståa^vodh
stååvedh	ståå^vedh
stænghkodh	stængh^kodh
stænghkodh	stængh^kodh
stænkodh	stæn^kodh
stïpmedh	stïp^medh
stööledh	stöö^ledh
stööredh	stöö^redh
stöövedh	stöö^vedh
sugnedh	sug^nedh
suhledh	suh^ledh
sujhtedh	sujh^tedh
surmedh	sur^medh
suvhtedh	suvh^tedh
suvnjedh	suv^njedh
suvredh	suv^redh
suvredh	suv^redh
suvtedh	suv^tedh
suvvedh	suv^vedh
svaadtedh	svaad^tedh
svaajlodh	svaaj^lodh
svaatjkodh	svaatj^kodh
svaejhtedh	svaejh^tedh
svarkedh	svar^kedh
svatjkedh	svatj^kedh
sveahkodh	sveah^kodh
sveallodh	sveal^lodh
sveedtedh	sveed^tedh
sveehkedh	sveeh^kedh
sveejhpedh	sveejh^pedh
sveeledh	svee^ledh
sviddedh	svid^dedh
svidtedh	svid^tedh
svihtjedh	svih^tjedh
svijdedh	svij^dedh
svijdedh	svij^dedh
svijredh	svij^redh
svijredh	svij^redh
svinhtedh	svinh^tedh
svirjedh	svir^jedh
svirredh	svir^redh
svitnedh	svit^nedh
svyölledh	svyöl^ledh
svålledh	svål^ledh
svååredh	svåå^redh
svæjkedh	svæj^kedh
svænhtodh	svænh^todh
svïeledh	svïe^ledh
svïhtjedh	svïh^tjedh
svïrredh	svïr^redh
syjhtedh	syjh^tedh
sylkedh	syl^kedh
syökedh	syö^kedh
såagkodh	såag^kodh
såahpodh	såah^podh
såajnodh	såaj^nodh
såajtodh	såaj^todh
såakedh	såa^kedh
såakodh	såa^kodh
såalmedh	såal^medh
såalmodh	såal^modh
såalnodh	såal^nodh
såamkedh	såam^kedh
såanedh	såa^nedh
såarhkedh	såarh^kedh
såarhkodh	såarh^kodh
såarkodh	såar^kodh
såavedh	såa^vedh
såavlodh	såav^lodh
såavodh	såa^vodh
såmskodh	såm^skodh
sårjodh	sår^jodh
sårkodh	sår^kodh
såvnjodh	såv^njodh
såvrodh	såv^rodh
sååjhtedh	sååjh^tedh
sååkedh	såå^kedh
såålhtedh	såålh^tedh
såårnedh	såår^nedh
sægkodh	sæg^kodh
sæhkodh	sæh^kodh
sæjhtjodh	sæjht^jodh
sæjkedh	sæj^kedh
sæjlodh	sæj^lodh
sæjngodh	sæj^ngodh
sïebpedh	sïeb^pedh
sïejedh	sïe^jedh
sïektedh	sïek^tedh
sïektjedh	sïek^tjedh
sïelkedh	sïel^kedh
sïemhtedh	sïemh^tedh
sïepedh	sïe^pedh
sïerredh	sïer^redh
sïhkedh	sïh^kedh
sïhpedh	sïh^pedh
sïjhpedh	sïjh^pedh
sïjhtedh	sïjh^tedh
sïjhtjedh	sïjht^jedh
sïjredh	sïj^redh
sïkngedh	sïk^ngedh
sïlkedh	sïl^kedh
sïlnedh	sïl^nedh
sïmmedh	sïm^medh
sïrredh	sïr^redh
sööhpedh	sööh^pedh
sööjnedh	sööj^nedh
söölsedh	sööl^sedh
söönedh	söö^nedh
sööpedh	söö^pedh
söörkedh	söör^kedh
söösedh	söö^sedh
söövledh	sööv^ledh
teehpedh	teeh^pedh
teeksedh	teek^sedh
teennedh	teen^nedh
teeredh	tee^redh
tjaabredh	tjaab^redh
tjaabrodh	tjaab^rodh
tjaagredh	tjaag^redh
tjaakodh	tjaa^kodh
tjaalkedh	tjaal^kedh
tjaangedh	tjaa^ngedh
tjaarhvedh	tjaarh^vedh
tjaavhkodh	tjaavh^kodh
tjabkodh	tjab^kodh
tjabredh	tjab^redh
tjaeledh	tjae^ledh
tjaesjmedh	tjaesj^medh
tjaevtedh	tjaev^tedh
tjaffedh	tjaf^fedh
tjaglodh	tjag^lodh
tjahkodh	tjah^kodh
tjahtedh	tjah^tedh
tjaktedh	tjak^tedh
tjalhvedh	tjalh^vedh
tjalkedh	tjal^kedh
tjalkedh	tjal^kedh
tjalledh	tjal^ledh
tjallodh	tjal^lodh
tjalmedh	tjal^medh
tjamkodh	tjam^kodh
tjanghkodh	tjangh^kodh
tjanhkodh	tjanh^kodh
tjankedh	tjan^kedh
tjarmedh	tjar^medh
tjarnedh	tjar^nedh
tjarvedh	tjar^vedh
tjatnedh	tjat^nedh
tjeadodh	tjea^dodh
tjeahkedh	tjeah^kedh
tjearodh	tjea^rodh
tjearvedh	tjear^vedh
tjeebredh	tjeeb^redh
tjeejskedh	tjeej^skedh
tjeekedh	tjee^kedh
tjeeskedh	tjees^kedh
tjeetsedh	tjee^tsedh
tjeevredh	tjeev^redh
tjeevtedh	tjeev^tedh
tjetskedh	tjets^kedh
tjevredh	tjev^redh
tjibkedh	tjib^kedh
tjievtedh	tjiev^tedh
tjijredh	tjij^redh
tjijtedh	tjij^tedh
tjilkedh	tjil^kedh
tjimkedh	tjim^kedh
tjiptedh	tjip^tedh
tjirkedh	tjir^kedh
tjirkedh	tjir^kedh
tjirmedh	tjir^medh
tjirredh	tjir^redh
tjoehpedh	tjoeh^pedh
tjoejedh	tjoe^jedh
tjoejkedh	tjoej^kedh
tjoekedh	tjoe^kedh
tjoeledh	tjoe^ledh
tjoelmedh	tjoel^medh
tjoemedh	tjoe^medh
tjoeredh	tjoe^redh
tjoermedh	tjoer^medh
tjoevkedh	tjoev^kedh
tjoevredh	tjoev^redh
tjohtjedh	tjoh^tjedh
tjolledh	tjol^ledh
tjonkedh	tjon^kedh
tjonnedh	tjon^nedh
tjoptedh	tjop^tedh
tjovredh	tjov^redh
tjuegkedh	tjueg^kedh
tjueltedh	tjuel^tedh
tjuetsedh	tjue^tsedh
tjuevtedh	tjuev^tedh
tjuhtedh	tjuh^tedh
tjulhtedh	tjulh^tedh
tjulledh	tjul^ledh
tjurhkedh	tjurh^kedh
tjurhtedh	tjurh^tedh
tjåadtjodh	tjåad^tjodh
tjåagkodh	tjåag^kodh
tjåaglodh	tjåag^lodh
tjåajhnodh	tjåajh^nodh
tjåakodh	tjåa^kodh
tjåalnodh	tjåal^nodh
tjåalodh	tjåa^lodh
tjåaptsodh	tjåap^tsodh
tjåaredh	tjåa^redh
tjåarvodh	tjåar^vodh
tjåatskodh	tjåats^kodh
tjåavodh	tjåa^vodh
tjåegkedh	tjåeg^kedh
tjåhkodh	tjåh^kodh
tjåktjedh	tjåk^tjedh
tjållodh	tjål^lodh
tjånghkodh	tjångh^kodh
tjåvtodh	tjåv^todh
tjååledh	tjåå^ledh
tjæjnodh	tjæj^nodh
tjæptsodh	tjæp^tsodh
tjïegledh	tjïeg^ledh
tjïehtedh	tjïeh^tedh
tjïekedh	tjïe^kedh
tjïektjedh	tjïek^tjedh
tjïeledh	tjïe^ledh
tjïelkedh	tjïel^kedh
tjïepedh	tjïe^pedh
tjïeskedh	tjïes^kedh
tjïevkedh	tjïev^kedh
tjïevledh	tjïev^ledh
tjïevnedh	tjïev^nedh
tjïevtedh	tjïev^tedh
tjïjnedh	tjïj^nedh
tjïktedh	tjïk^tedh
tjïrredh	tjïr^redh
tjïvkedh	tjïv^kedh
tjööledh	tjöö^ledh
tjöönedh	tjöö^nedh
tjöönghkedh	tjööngh^kedh
tjöönghkedh	tjööngh^kedh
tjööpkedh	tjööp^kedh
tjöörhtjedh	tjöörht^jedh
tjöörvedh	tjöör^vedh
tjööskedh	tjöös^kedh
traasmedh	traas^medh
tramhkodh	tramh^kodh
trapkedh	trap^kedh
travsodh	trav^sodh
treahtodh	treah^todh
treapkedh	treap^kedh
treegkedh	treeg^kedh
treemhpedh	treemh^pedh
treevedh	tree^vedh
trimhkedh	trimh^kedh
truvsedh	truv^sedh
tråabpodh	tråab^podh
tråapkodh	tråap^kodh
tråasodh	tråa^sodh
tråvsodh	tråv^sodh
trïesedh	trïe^sedh
trïhpedh	trïh^pedh
trïjsedh	trïj^sedh
trïpmedh	trïp^medh
trööredh	tröö^redh
tsaapedh	tsaa^pedh
tsaapkedh	tsaap^kedh
tsaatsedh	tsaa^tsedh
tsabtsedh	tsab^tsedh
tsaekedh	tsae^kedh
tsaepmedh	tsaep^medh
tsagkedh	tsag^kedh
tsahtsodh	tsah^tsodh
tsallodh	tsal^lodh
tsamtsedh	tsam^tsedh
tsanhkedh	tsanh^kedh
tsapkedh	tsap^kedh
tseagkodh	tseag^kodh
tseahkodh	tseah^kodh
tseavodh	tsea^vodh
tseegkedh	tseeg^kedh
tseepkedh	tseep^kedh
tseevedh	tsee^vedh
tsevtsedh	tsev^tsedh
tsielhkedh	tsielh^kedh
tsiemedh	tsie^medh
tsietsedh	tsie^tsedh
tsiptsedh	tsip^tsedh
tsomhtsedh	tsomht^sedh
tsueptsedh	tsuep^tsedh
tsuvtsedh	tsuv^tsedh
tsuvvedh	tsuv^vedh
tsåakodh	tsåa^kodh
tsåalhkodh	tsåalh^kodh
tsåapkodh	tsåap^kodh
tsåavtsodh	tsåav^tsodh
tsåeptsedh	tsåep^tsedh
tsånkedh	tsån^kedh
tsællodh	tsæl^lodh
tsætskodh	tsæts^kodh
tsïehkedh	tsïeh^kedh
tsïeledh	tsïe^ledh
tsïelhkedh	tsïelh^kedh
tsïelkedh	tsïel^kedh
tsïhkedh	tsïh^kedh
tsïjhtsedh	tsïjht^sedh
tsïjnedh	tsïj^nedh
tsïjredh	tsïj^redh
tsïjtsedh	tsïj^tsedh
tsööpkedh	tsööp^kedh
tuhtjedh	tuh^tjedh
tuvnedh	tuv^nedh
tååhpedh	tååh^pedh
tïemedh	tïe^medh
tööledh	töö^ledh
töölledh	tööl^ledh
ulhtedh	ulh^tedh
ulledh	ul^ledh
ulpedh	ul^pedh
ultedh	ul^tedh
ulvedh	ul^vedh
urhtsedh	urht^sedh
urpedh	ur^pedh
urtedh	ur^tedh
utnedh	ut^nedh
uvhtedh	uvh^tedh
uvtedh	uv^tedh
vaajkedh	vaaj^kedh
vaajvedh	vaaj^vedh
vaaksjedh	vaak^sjedh
vaaksjodh	vaak^sjodh
vaaljodh	vaa^ljodh
vaalledh	vaal^ledh
vaalodh	vaa^lodh
vaanodh	vaa^nodh
vaarhkedh	vaarh^kedh
vaarredh	vaar^redh
vaarvodh	vaar^vodh
vaasedh	vaa^sedh
vaastodh	vaas^todh
vaedtsedh	vaed^tsedh
vaejtedh	vaej^tedh
vaeltedh	vael^tedh
vaerhkedh	vaerh^kedh
vaesedh	vae^sedh
vaetedh	vae^tedh
vahkedh	vah^kedh
vajmedh	vaj^medh
vajvedh	vaj^vedh
valkedh	val^kedh
valvedh	val^vedh
vanjkedh	vanj^kedh
vanjkodh	vanj^kodh
varhtodh	varh^todh
varkedh	var^kedh
vasjnjodh	vasj^njodh
veajedh	vea^jedh
veajkodh	veaj^kodh
veajodh	vea^jodh
veaksodh	veak^sodh
vealkedh	veal^kedh
vealodh	vea^lodh
veanhtedh	veanh^tedh
vearedh	vea^redh
veasjodh	vea^sjodh
veasodh	vea^sodh
veatodh	vea^todh
vedtedh	ved^tedh
veedtjedh	veed^tjedh
veejhtedh	veejh^tedh
veeledh	vee^ledh
veeljedh	vee^ljedh
veeredh	vee^redh
veerhkedh	veerh^kedh
veesmedh	vees^medh
veevedh	vee^vedh
vemhtedh	vemh^tedh
vemtedh	vem^tedh
vertedh	ver^tedh
viedtedh	vied^tedh
viejedh	vie^jedh
viejredh	viej^redh
viertedh	vier^tedh
vievsedh	viev^sedh
vijjedh	vij^jedh
vijredh	vij^redh
vilnjedh	vil^njedh
virtedh	vir^tedh
vissjedh	vis^sjedh
vistedh	vis^tedh
vitnedh	vit^nedh
voehtjedh	voeh^tjedh
voejedh	voe^jedh
voejtedh	voej^tedh
voeledh	voe^ledh
voeredh	voe^redh
voessjedh	voes^sjedh
voetsedh	voe^tsedh
voevtsedh	voev^tsedh
vuarhkedh	vuarh^kedh
vuarkedh	vuar^kedh
vuehtedh	vueh^tedh
vuejedh	vue^jedh
vuejnedh	vuej^nedh
vuelkedh	vuel^kedh
vuelmedh	vuel^medh
vuerhkedh	vuerh^kedh
vuerkedh	vuer^kedh
vuertedh	vuer^tedh
vuesvedh	vues^vedh
vuetjedh	vue^tjedh
vuetkedh	vuet^kedh
vuetsedh	vue^tsedh
vuevjedh	vuev^jedh
vuevtsedh	vuev^tsedh
vuhtsedh	vuh^tsedh
vyjhpedh	vyjh^pedh
vyjredh	vyj^redh
vystedh	vys^tedh
vyöjpedh	vyöj^pedh
vyökedh	vyö^kedh
vyöskedh	vyös^kedh
våadtjodh	våad^tjodh
våajodh	våa^jodh
våajpodh	våaj^podh
våarnodh	våar^nodh
våarpodh	våar^podh
våatjodh	våa^tjodh
våhtsodh	våh^tsodh
våvnedh	våv^nedh
vååhtedh	vååh^tedh
vååjhtedh	vååjh^tedh
vååjnedh	vååj^nedh
væjkodh	væj^kodh
væjmodh	væj^modh
væjnodh	væj^nodh
væjrodh	væj^rodh
vælnjedh	væl^njedh
værhtodh	værh^todh
væssjodh	væs^sjodh
vïebredh	vïeb^redh
vïedtjedh	vïed^tjedh
vïekedh	vïe^kedh
vïelkedh	vïel^kedh
vïenhtedh	vïenh^tedh
vïeredh	vïe^redh
vïjjedh	vïj^jedh
vïjredh	vïj^redh
vïssjedh	vïs^sjedh
vïtnedh	vït^nedh
vïtnjedh	vït^njedh
vöörhkedh	vöörh^kedh
vöövtedh	vööv^tedh
yörhkedh	yörh^kedh
åabpedh	åab^pedh
åadtjodh	åad^tjodh
åahpodh	åah^podh
åajsodh	åaj^sodh
åarkodh	åar^kodh
åavhtodh	åavh^todh
åavrodh	åav^rodh
åbrodh	åb^rodh
åeredh	åe^redh
åestedh	åes^tedh
ålmodh	ål^modh
årrodh	år^rodh
ååktedh	ååk^tedh
ååntedh	åån^tedh
ååvnedh	ååv^nedh
æbjodh	æb^jodh
ærmodh	ær^modh
ïervedh	ïer^vedh
ööledh	öö^ledh
öörnedh	öör^nedh
