addeeredh	ad^dee^redh
ageeredh	a^gee^redh
apteeredh	ap^tee^redh
armeeredh	ar^mee^redh
barbeeredh	bar^bee^redh
baseeredh	ba^see^redh
blameeredh	bla^mee^redh
blokkeeredh	blok^kee^redh
blokkeeredh	blok^kee^redh
bogseeredh	bog^see^redh
braveeredh	bra^vee^redh
breseeredh	bre^see^redh
briljeeredh	bri^ljee^redh
brodeeredh	bro^dee^redh
bronseeredh	bron^see^redh
brosjeeredh	bro^sjee^redh
brosjeeredh	bro^sjee^redh
bukseeredh	buk^see^redh
dandeeredh	dan^dee^redh
dateeredh	da^tee^redh
deleeredh	de^lee^redh
dikteeredh	dik^tee^redh
doneeredh	do^nee^redh
doseeredh	do^see^redh
dosseeredh	dos^see^redh
doteeredh	do^tee^redh
drapeeredh	dra^pee^redh
drasjeeredh	dra^sjee^redh
dresseeredh	dres^see^redh
dräneeredh	drä^nee^redh
dubbleeredh	dubb^lee^redh
dubleeredh	dub^lee^redh
duelleeredh	duel^lee^redh
dupeeredh	du^pee^redh
ekseeredh	ek^see^redh
ekseeredh	ek^see^redh
falleeredh	fal^lee^redh
farseeredh	far^see^redh
feteeredh	fe^tee^redh
fikseeredh	fik^see^redh
fileeredh	fi^lee^redh
filtreeredh	filt^ree^redh
fingeeredh	fi^ngee^redh
flambeeredh	flam^bee^redh
flankeeredh	flan^kee^redh
flatteeredh	flat^tee^redh
flekteeredh	flek^tee^redh
floreeredh	flo^ree^redh
forseeredh	for^see^redh
frankeeredh	fran^kee^redh
frappeeredh	frap^pee^redh
fraseeredh	fra^see^redh
friseeredh	fri^see^redh
friteeredh	fri^tee^redh
frondeeredh	fron^dee^redh
frotteeredh	frot^tee^redh
frustreeredh	frust^ree^redh
fundeeredh	fun^dee^redh
fungeeredh	fu^ngee^redh
furneeredh	fur^nee^redh
gageeredh	ga^gee^redh
gardeeredh	gar^dee^redh
garneeredh	gar^nee^redh
gasjeeredh	ga^sjee^redh
geneeredh	ge^nee^redh
gereeredh	ge^ree^redh
gireeredh	gi^ree^redh
glaseeredh	gla^see^redh
glasseeredh	glas^see^redh
gradeeredh	gra^dee^redh
grasseeredh	gras^see^redh
graveeredh	gra^vee^redh
griljeeredh	gri^ljee^redh
grundeeredh	grun^dee^redh
gruppeeredh	grup^pee^redh
guteeredh	gu^tee^redh
hoveeredh	ho^vee^redh
jodeeredh	jo^dee^redh
justeeredh	jus^tee^redh
kalkeeredh	kal^kee^redh
kampeeredh	kam^pee^redh
karteeredh	kar^tee^redh
kasseeredh	kas^see^redh
kastreeredh	kast^ree^redh
kaveeredh	ka^vee^redh
klareeredh	kla^ree^redh
klisjeeredh	kli^sjee^redh
klisjeeredh	kli^sjee^redh
kloreeredh	klo^ree^redh
konteeredh	kon^tee^redh
koseeredh	ko^see^redh
krejeeredh	kre^jee^redh
krejeeredh	kre^jee^redh
kremeeredh	kre^mee^redh
krepeeredh	kre^pee^redh
krokeeredh	kro^kee^redh
krokkeeredh	krok^kee^redh
krokkeeredh	krok^kee^redh
krypteeredh	kryp^tee^redh
kubeeredh	ku^bee^redh
kupeeredh	ku^pee^redh
kureeredh	ku^ree^redh
kurseeredh	kur^see^redh
kvadreeredh	kvad^ree^redh
kvitteeredh	kvit^tee^redh
kvitteeredh	kvit^tee^redh
kvitteeredh	kvit^tee^redh
kvoteeredh	kvo^tee^redh
kåseeredh	kå^see^redh
lakkeeredh	lak^kee^redh
lakkeeredh	lak^kee^redh
lakseeredh	lak^see^redh
lanseeredh	lan^see^redh
laseeredh	la^see^redh
legeeredh	le^gee^redh
leveeredh	le^vee^redh
linjeeredh	li^njee^redh
logeeredh	lo^gee^redh
longeeredh	lo^ngee^redh
losjeeredh	lo^sjee^redh
lukreeredh	lu^kree^redh
lukseeredh	luk^see^redh
mankeeredh	man^kee^redh
markeeredh	mar^kee^redh
marseeredh	mar^see^redh
marsjeeredh	mar^sjee^redh
maskeeredh	mas^kee^redh
masseeredh	mas^see^redh
matteeredh	mat^tee^redh
meleeredh	me^lee^redh
migreeredh	mig^ree^redh
monteeredh	mon^tee^redh
moveeredh	mo^vee^redh
muljeeredh	mu^ljee^redh
mulkteeredh	mulk^tee^redh
musseeredh	mus^see^redh
muteeredh	mu^tee^redh
möbleeredh	möb^lee^redh
møbleeredh	møb^lee^redh
negeeredh	ne^gee^redh
nikseeredh	nik^see^redh
nitreeredh	nit^ree^redh
normeeredh	nor^mee^redh
noteeredh	no^tee^redh
opteeredh	op^tee^redh
palpeeredh	pal^pee^redh
paneeredh	pa^nee^redh
pareeredh	pa^ree^redh
parkeeredh	par^kee^redh
parleeredh	par^lee^redh
parteeredh	par^tee^redh
passeeredh	pas^see^redh
planeeredh	pla^nee^redh
plasseeredh	plas^see^redh
pledeeredh	ple^dee^redh
pletteeredh	plet^tee^redh
plisseeredh	plis^see^redh
plombeeredh	plom^bee^redh
plotteeredh	plot^tee^redh
plädeeredh	plä^dee^redh
poengteeredh	poeng^tee^redh
poleeredh	po^lee^redh
poneeredh	po^nee^redh
ponseeredh	pon^see^redh
ponseeredh	pon^see^redh
poseeredh	po^see^redh
posjeeredh	po^sjee^redh
posjeeredh	po^sjee^redh
posteeredh	pos^tee^redh
presteeredh	pres^tee^redh
probeeredh	pro^bee^redh
proneeredh	pro^nee^redh
pulseeredh	pul^see^redh
punkteeredh	punk^tee^redh
radeeredh	ra^dee^redh
raljeeredh	ra^ljee^redh
rangeeredh	ra^ngee^redh
raseeredh	ra^see^redh
reageeredh	rea^gee^redh
regjeeredh	reg^jee^redh
resteeredh	res^tee^redh
riskeeredh	ris^kee^redh
rokeeredh	ro^kee^redh
romsteeredh	rom^stee^redh
roteeredh	ro^tee^redh
rulleeredh	rul^lee^redh
rumsteeredh	rum^stee^redh
saldeeredh	sal^dee^redh
sentreeredh	sent^ree^redh
sentreeredh	sent^ree^redh
serveeredh	ser^vee^redh
siffreeredh	siff^ree^redh
sifreeredh	sif^ree^redh
siteeredh	si^tee^redh
siteeredh	si^tee^redh
sjangeeredh	sja^ngee^redh
sjangeeredh	sja^ngee^redh
sjarmeeredh	sjar^mee^redh
sjarmeeredh	sjar^mee^redh
sjatteeredh	sjat^tee^redh
sjiffreeredh	sjiff^ree^redh
sjiffreeredh	sjiff^ree^redh
sjokkeeredh	sjok^kee^redh
skaleeredh	ska^lee^redh
skalpeeredh	skal^pee^redh
skamfeeredh	skam^fee^redh
skandeeredh	skan^dee^redh
skisseeredh	skis^see^redh
skoleeredh	sko^lee^redh
skraveeredh	skra^vee^redh
skulpteeredh	skulp^tee^redh
sondeeredh	son^dee^redh
sorteeredh	sor^tee^redh
spandeeredh	span^dee^redh
spaseeredh	spa^see^redh
spatseeredh	spa^tsee^redh
spoleeredh	spo^lee^redh
staffeeredh	staf^fee^redh
stoltseeredh	stol^tsee^redh
studeeredh	stu^dee^redh
suffleeredh	suff^lee^redh
summeeredh	sum^mee^redh
supeeredh	su^pee^redh
suppleeredh	supp^lee^redh
takseeredh	tak^see^redh
takseeredh	tak^see^redh
takteeredh	tak^tee^redh
tangeeredh	ta^ngee^redh
tendeeredh	ten^dee^redh
titreeredh	tit^ree^redh
torteeredh	tor^tee^redh
tradeeredh	tra^dee^redh
trakteeredh	trak^tee^redh
transjeeredh	tran^sjee^redh
transjeeredh	tran^sjee^redh
traseeredh	tra^see^redh
trasseeredh	tras^see^redh
träneeredh	trä^nee^redh
tupeeredh	tu^pee^redh
turneeredh	tur^nee^redh
tusjeeredh	tu^sjee^redh
tusjeeredh	tu^sjee^redh
urgeeredh	ur^gee^redh
valveeredh	val^vee^redh
vatteeredh	vat^tee^redh
verseeredh	ver^see^redh
vibreeredh	vib^ree^redh
viseeredh	vi^see^redh
volteeredh	vol^tee^redh
vomeeredh	vo^mee^redh
voteeredh	vo^tee^redh
vurdeeredh	vur^dee^redh
