aablahtovvedh	aab^lah^tov^vedh
aablarostedh	aab^la^ros^tedh
aahkastehtedh	aah^kas^teh^tedh
aajahtalledh	aa^jah^tal^ledh
aajaldehtedh	aa^jal^deh^tedh
aajhpehtovvedh	aajh^peh^tov^vedh
aajjastehtedh	aaj^jas^teh^tedh
aajkardalledh	aaj^kar^dal^ledh
aajpanahtjedh	aaj^pa^nah^tjedh
aajpanestedh	aaj^pa^nes^tedh
aajvardalledh	aaj^var^dal^ledh
aalhtedehtedh	aalh^te^deh^tedh
aalhterostedh	aalh^te^ros^tedh
aalterostedh	aal^te^ros^tedh
aarhkalestedh	aarh^ka^les^tedh
aarmalestedh	aar^ma^les^tedh
aarmarostedh	aar^ma^ros^tedh
aarmelostedh	aar^me^los^tedh
aarmoelostedh	aar^moe^los^tedh
aarvadalledh	aar^va^dal^ledh
aassjoehtovvedh	aas^sjoeh^tov^vedh
aassjoestehtedh	aas^sjoes^teh^tedh
aaterostedh	aa^te^ros^tedh
aavoedehtedh	aa^voe^deh^tedh
aavtaradtedh	aav^ta^rad^tedh
aavtarehtedh	aav^ta^reh^tedh
aavtarostedh	aav^ta^ros^tedh
abbonneeredh	ab^bon^nee^redh
abdiseeredh	ab^di^see^redh
abonneeredh	a^bon^nee^redh
aborteeredh	a^bor^tee^redh
abpehtovvedh	ab^peh^tov^vedh
absenteeredh	ab^sen^tee^redh
absolveeredh	ab^sol^vee^redh
absorbeeredh	ab^sor^bee^redh
abstraheeredh	abst^ra^hee^redh
adapteeredh	a^dap^tee^redh
adhereeredh	ad^he^ree^redh
adopteeredh	a^dop^tee^redh
adresseeredh	ad^res^see^redh
adsorbeeredh	ad^sor^bee^redh
adstringeeredh	adst^ri^ngee^redh
adtenjadtedh	ad^te^njad^tedh
adviseeredh	ad^vi^see^redh
aebliehtovvedh	aeb^lieh^tov^vedh
aejkiestahtjedh	aej^kies^tah^tjedh
aejliestovvedh	aej^lies^tov^vedh
aemiejuetjedh	ae^mie^jue^tjedh
aemiejöösjedh	ae^mie^jöö^sjedh
aemieluesedh	ae^mie^lue^sedh
aepiebalsedh	ae^pie^bal^sedh
affekteeredh	af^fek^tee^redh
affikseeredh	af^fik^see^redh
affikseeredh	af^fik^see^redh
affiseeredh	af^fi^see^redh
agiteeredh	a^gi^tee^redh
agkaldalledh	ag^kal^dal^ledh
ajkardalledh	aj^kar^dal^ledh
ajtoedehtedh	aj^toe^deh^tedh
akkedeeredh	ak^ke^dee^redh
akkordeeredh	ak^kor^dee^redh
akkordeeredh	ak^kor^dee^redh
akkvireeredh	ak^kvi^ree^redh
akkvireeredh	ak^kvi^ree^redh
aksepteeredh	ak^sep^tee^redh
aksepteeredh	ak^sep^tee^redh
aksjoneeredh	ak^sjo^nee^redh
aktanadtedh	ak^ta^nad^tedh
aktiveeredh	ak^ti^vee^redh
aktueeredh	ak^tu^ee^redh
aktuveeredh	ak^tu^vee^redh
alarmeeredh	a^lar^mee^redh
allijeeredh	al^li^jee^redh
allijeeredh	al^li^jee^redh
allokeeredh	al^lo^kee^redh
alludeeredh	al^lu^dee^redh
almastalledh	al^mas^tal^ledh
altereeredh	al^te^ree^redh
alterneeredh	al^ter^nee^redh
alvehtehtedh	al^veh^teh^tedh
alvehtovvedh	al^veh^tov^vedh
alvesadtedh	al^ve^sad^tedh
alveskovvedh	al^ves^kov^vedh
ambuleeredh	am^bu^lee^redh
amputeeredh	am^pu^tee^redh
angliseeredh	ang^li^see^redh
animeeredh	a^ni^mee^redh
annekteeredh	an^nek^tee^redh
annonseeredh	an^non^see^redh
annoteeredh	an^no^tee^redh
annulleeredh	an^nul^lee^redh
antanadtedh	an^ta^nad^tedh
appelleeredh	ap^pel^lee^redh
appliseeredh	app^li^see^redh
appliseeredh	app^li^see^redh
appliseeredh	app^li^see^redh
applådeeredh	app^lå^dee^redh
apporteeredh	ap^por^tee^redh
appreteeredh	app^re^tee^redh
approbeeredh	app^ro^bee^redh
apsahtalledh	ap^sah^tal^ledh
aresteeredh	a^res^tee^redh
arhpehtovvedh	arh^peh^tov^vedh
arhtegåetedh	arh^te^gåe^tedh
arhtelgovvedh	arh^tel^gov^vedh
arhtijahtjedh	arh^ti^jah^tjedh
arkiveeredh	ar^ki^vee^redh
armoedehtedh	ar^moe^deh^tedh
arrangeeredh	ar^ra^ngee^redh
arresteeredh	ar^res^tee^redh
arreteeredh	ar^re^tee^redh
arriveeredh	ar^ri^vee^redh
arrondeeredh	ar^ron^dee^redh
asfalteeredh	as^fal^tee^redh
aspereeredh	as^pe^ree^redh
aspireeredh	as^pi^ree^redh
assisteeredh	as^sis^tee^redh
assjadalledh	as^sja^dal^ledh
assorteeredh	as^sor^tee^redh
assureeredh	as^su^ree^redh
astedalledh	as^te^dal^ledh
astringeeredh	ast^ri^ngee^redh
asvedahtjedh	as^ve^dah^tjedh
asvedovvedh	as^ve^dov^vedh
asvedïhtjedh	as^ve^dïh^tjedh
atnahtalledh	at^nah^tal^ledh
attakkeeredh	at^tak^kee^redh
attakkeeredh	at^tak^kee^redh
attasjeeredh	at^ta^sjee^redh
attasjeeredh	at^ta^sjee^redh
attesteeredh	at^tes^tee^redh
attraheeredh	att^ra^hee^redh
attrappeeredh	att^rap^pee^redh
auksjoneeredh	auk^sjo^nee^redh
avaleeredh	a^va^lee^redh
avanseeredh	a^van^see^redh
averteeredh	a^ver^tee^redh
baadtasovvedh	baad^ta^sov^vedh
baahkestovvedh	baah^kes^tov^vedh
baajhtaldalledh	baajh^tal^dal^ledh
baajhtalgovvedh	baajh^tal^gov^vedh
baajhtasoevedh	baajh^ta^soe^vedh
baajhtasovvedh	baajh^ta^sov^vedh
baaltestehtedh	baal^tes^teh^tedh
baanahtehtedh	baa^nah^teh^tedh
baanahtoevedh	baa^nah^toe^vedh
baanahtovvedh	baa^nah^tov^vedh
baanhtsarostedh	baanht^sa^ros^tedh
baartahtalledh	baar^tah^tal^ledh
baataradtedh	baa^ta^rad^tedh
baavijahtjedh	baa^vi^jah^tjedh
baavoejahtjedh	baa^voe^jah^tjedh
baavrestehtedh	baav^res^teh^tedh
baektjiegåetedh	baek^tjie^gåe^tedh
baeniehtovvedh	bae^nieh^tov^vedh
baerhkieldistedh	baerh^kiel^dis^tedh
bajhkahtalledh	bajh^kah^tal^ledh
bajhkehtjadtedh	bajh^keh^tjad^tedh
bajkasovvedh	baj^ka^sov^vedh
balanseeredh	ba^lan^see^redh
balloteeredh	bal^lo^tee^redh
ballotteeredh	bal^lot^tee^redh
balsameeredh	bal^sa^mee^redh
baltahtalledh	bal^tah^tal^ledh
bandageeredh	ban^da^gee^redh
bandasjeeredh	ban^da^sjee^redh
banhkestalledh	banh^kes^tal^ledh
bansjijahtjedh	ban^sji^jah^tjedh
barduneeredh	bar^du^nee^redh
barkestehtedh	bar^kes^teh^tedh
barregoevedh	bar^re^goe^vedh
barrestalledh	bar^res^tal^ledh
bartestehtedh	bar^tes^teh^tedh
baskehtalledh	bas^keh^tal^ledh
baskijahtjedh	bas^ki^jah^tjedh
bastaldehtedh	bas^tal^deh^tedh
bastestehtedh	bas^tes^teh^tedh
basuneeredh	ba^su^nee^redh
batnesoevedh	bat^ne^soe^vedh
beadtasovvedh	bead^ta^sov^vedh
beahtahtalledh	beah^tah^tal^ledh
beahtasovvedh	beah^ta^sov^vedh
beajstehtjadtedh	beaj^steh^tjad^tedh
bealhkahtovvedh	bealh^kah^tov^vedh
bealhkasovvedh	bealh^ka^sov^vedh
beatskadalledh	beats^ka^dal^ledh
beavnjahtalledh	beav^njah^tal^ledh
beelhkesovvedh	beelh^ke^sov^vedh
biehtiehtovvedh	bieh^tieh^tov^vedh
bieljiehtovvedh	bie^ljieh^tov^vedh
bigkehtehtedh	big^keh^teh^tedh
biljetteeredh	bi^ljet^tee^redh
billetteeredh	bil^let^tee^redh
bitnehtistedh	bit^neh^tis^tedh
bivakkeeredh	bi^vak^kee^redh
bivakkeeredh	bi^vak^kee^redh
bivuakkeeredh	bi^vuak^kee^redh
blasoneeredh	bla^so^nee^redh
bleerkehtalledh	bleer^keh^tal^ledh
boejhkehtalledh	boejh^keh^tal^ledh
boelvestalledh	boel^ves^tal^ledh
boerhkenestedh	boerh^ke^nes^tedh
boerkestehtedh	boer^kes^teh^tedh
boevhredehtedh	boevh^re^deh^tedh
boevrerehtedh	boev^re^reh^tedh
bofferdïhtjedh	bof^fer^dïh^tjedh
bohtjehtjadtedh	boh^tjeh^tjad^tedh
bokstaveeredh	bok^sta^vee^redh
bombardeeredh	bom^bar^dee^redh
bonhkehtalledh	bonh^keh^tal^ledh
boniteeredh	bo^ni^tee^redh
bontserostedh	bon^tse^ros^tedh
borrestovvedh	bor^res^tov^vedh
borserostedh	bor^se^ros^tedh
bosselostedh	bos^se^los^tedh
botnesovvedh	bot^ne^sov^vedh
botnjelostedh	bot^nje^los^tedh
botnjesadtedh	bot^nje^sad^tedh
bovveladtedh	bov^ve^lad^tedh
bovvestovvedh	bov^ves^tov^vedh
briketteeredh	bri^ket^tee^redh
bualahtehtedh	bua^lah^teh^tedh
bualajahtjedh	bua^la^jah^tjedh
bualalgovvedh	bua^lal^gov^vedh
buaradalledh	bua^ra^dal^ledh
buaradehtedh	bua^ra^deh^tedh
buarastalledh	bua^ras^tal^ledh
buarastehtedh	bua^ras^teh^tedh
buasarostedh	bua^sa^ros^tedh
buasjahtehtedh	bua^sjah^teh^tedh
buasjahtovvedh	bua^sjah^tov^vedh
budjeteeredh	bud^je^tee^redh
budsjetteeredh	bud^sjet^tee^redh
byjestovvedh	by^jes^tov^vedh
byjjesovvedh	byj^je^sov^vedh
byjrehtalledh	byj^reh^tal^ledh
byjrehtovvedh	byj^reh^tov^vedh
byjrestehtedh	byj^res^teh^tedh
byjvestovvedh	byj^ves^tov^vedh
byssijïhtjedh	bys^si^jïh^tjedh
bysvesovvedh	bys^ve^sov^vedh
bysvijahtjedh	bys^vi^jah^tjedh
byöhkestehtedh	byöh^kes^teh^tedh
byöpmedalledh	byöp^me^dal^ledh
byöpmedistedh	byöp^me^dis^tedh
byörhkestehtedh	byörh^kes^teh^tedh
båajtadehtedh	båaj^ta^deh^tedh
båalahtehtedh	båa^lah^teh^tedh
båalasadtedh	båa^la^sad^tedh
båaltajehtedh	båal^ta^jeh^tedh
båaradalledh	båa^ra^dal^ledh
båarastovvedh	båa^ras^tov^vedh
båarhkoedestedh	båarh^koe^des^tedh
båarkadehtedh	båar^ka^deh^tedh
båarvadehtedh	båar^va^deh^tedh
båasardehtedh	båa^sar^deh^tedh
båasarostedh	båa^sa^ros^tedh
båatahtalledh	båa^tah^tal^ledh
bådtjalgovvedh	båd^tjal^gov^vedh
bårregovvedh	bår^re^gov^vedh
bårrehtalledh	bår^reh^tal^ledh
bårrestalledh	bår^res^tal^ledh
bårrestohtedh	bår^res^toh^tedh
bårrestovvedh	bår^res^tov^vedh
båssalostedh	bås^sa^los^tedh
båvsalostedh	båv^sa^los^tedh
båvsarostedh	båv^sa^ros^tedh
båvvasovvedh	båv^va^sov^vedh
båvvastehtedh	båv^vas^teh^tedh
bååhperostedh	bååh^pe^ros^tedh
bååkestalledh	båå^kes^tal^ledh
båånhtserostedh	båånht^se^ros^tedh
båånhtserostedh	båånht^se^ros^tedh
båårhkelgovvedh	båårh^kel^gov^vedh
båårhkelovvedh	båårh^ke^lov^vedh
bååveldïhtjedh	båå^vel^dïh^tjedh
bæhkasovvedh	bæh^ka^sov^vedh
bæktahtalledh	bæk^tah^tal^ledh
bæssahtalledh	bæs^sah^tal^ledh
bïedtehtovvedh	bïed^teh^tov^vedh
bïejelgovvedh	bïe^jel^gov^vedh
bïejeskovvedh	bïe^jes^kov^vedh
bïejstehtjadtedh	bïej^steh^tjad^tedh
bïelhkehtjadtedh	bïelh^keh^tjad^tedh
bïeselistedh	bïe^se^lis^tedh
bïevestehtedh	bïe^ves^teh^tedh
bïevestohtedh	bïe^ves^toh^tedh
bïevestovvedh	bïe^ves^tov^vedh
bïhkehtjistedh	bïh^keh^tjis^tedh
bïjrestehtedh	bïj^res^teh^tedh
bïjveldehtedh	bïj^vel^deh^tedh
bïjvestovvedh	bïj^ves^tov^vedh
bïjvijadtedh	bïj^vi^jad^tedh
bïjvijahtjedh	bïj^vi^jah^tjedh
bïllestovvedh	bïl^les^tov^vedh
bïllijadtedh	bïl^li^jad^tedh
bïlsedovvedh	bïl^se^dov^vedh
bïlsestoevedh	bïl^ses^toe^vedh
bïsselgovvedh	bïs^sel^gov^vedh
böörenjestedh	böö^re^njes^tedh
bööresovvedh	böö^re^sov^vedh
böötehtehtedh	böö^teh^teh^tedh
daajmarostedh	daaj^ma^ros^tedh
daajrehtalledh	daaj^reh^tal^ledh
daalvadovvedh	daal^va^dov^vedh
daanjehtalledh	daa^njeh^tal^ledh
daanjijahtjedh	daa^nji^jah^tjedh
daatjadovvedh	daa^tja^dov^vedh
dabrahtalledh	dab^rah^tal^ledh
dabranadtedh	dab^ra^nad^tedh
dabranadtedh	dab^ra^nad^tedh
dabranestedh	dab^ra^nes^tedh
dabreldehtedh	dab^rel^deh^tedh
dabreldestedh	dab^rel^des^tedh
dabrelestedh	dab^re^les^tedh
dabtehtalledh	dab^teh^tal^ledh
dabtehtistedh	dab^teh^tis^tedh
dabtesadtedh	dab^te^sad^tedh
daelviedovvedh	dael^vie^dov^vedh
dahparostedh	dah^pa^ros^tedh
dahpelostedh	dah^pe^los^tedh
daltelgovvedh	dal^tel^gov^vedh
damaskeeredh	da^mas^kee^redh
damaskeeredh	da^mas^kee^redh
damtehtalledh	dam^teh^tal^ledh
damtehtistedh	dam^teh^tis^tedh
damtesadtedh	dam^te^sad^tedh
damtestalledh	dam^tes^tal^ledh
dapkedehtedh	dap^ke^deh^tedh
dapkerehtedh	dap^ke^reh^tedh
darhperostedh	darh^pe^ros^tedh
darhpestehtedh	darh^pes^teh^tedh
darvalgovvedh	dar^val^gov^vedh
dassedistedh	das^se^dis^tedh
davhkehtalledh	davh^keh^tal^ledh
davhkehtalledh	davh^keh^tal^ledh
deadadehtedh	dea^da^deh^tedh
deadedehtedh	dea^de^deh^tedh
dealasovvedh	dea^la^sov^vedh
dealastehtedh	dea^las^teh^tedh
dearoedehtedh	dea^roe^deh^tedh
debankeeredh	de^ban^kee^redh
debarkeeredh	de^bar^kee^redh
debatteeredh	de^bat^tee^redh
debiteeredh	de^bi^tee^redh
debreldehtedh	deb^rel^deh^tedh
debuteeredh	de^bu^tee^redh
dediseeredh	de^di^see^redh
dediseeredh	de^di^see^redh
deduseeredh	de^du^see^redh
deduseeredh	de^du^see^redh
deehkehtalledh	deeh^keh^tal^ledh
deerehtalledh	dee^reh^tal^ledh
defileeredh	de^fi^lee^redh
defineeredh	de^fi^nee^redh
deflateeredh	def^la^tee^redh
defloreeredh	def^lo^ree^redh
deformeeredh	de^for^mee^redh
degradeeredh	deg^ra^dee^redh
dehydreeredh	de^hyd^ree^redh
dekanteeredh	de^kan^tee^redh
dekateeredh	de^ka^tee^redh
deklameeredh	de^kla^mee^redh
deklareeredh	de^kla^ree^redh
deklasseeredh	de^klas^see^redh
deklineeredh	de^kli^nee^redh
dekoreeredh	de^ko^ree^redh
dekorteeredh	de^kor^tee^redh
dekreteeredh	de^kre^tee^redh
dekupeeredh	de^ku^pee^redh
delegeeredh	de^le^gee^redh
delireeredh	de^li^ree^redh
demaskeeredh	de^mas^kee^redh
dementeeredh	de^men^tee^redh
demoleeredh	de^mo^lee^redh
demonstreeredh	de^monst^ree^redh
demonteeredh	de^mon^tee^redh
denoteeredh	de^no^tee^redh
denudeeredh	de^nu^dee^redh
deponeeredh	de^po^nee^redh
deporteeredh	de^por^tee^redh
depraveeredh	dep^ra^vee^redh
deprimeeredh	dep^ri^mee^redh
deputeeredh	de^pu^tee^redh
derangeeredh	de^ra^ngee^redh
deriveeredh	de^ri^vee^redh
desarmeeredh	de^sar^mee^redh
deserteeredh	de^ser^tee^redh
desideeredh	de^si^dee^redh
designeeredh	de^sig^nee^redh
desimeeredh	de^si^mee^redh
desimeeredh	de^si^mee^redh
desjiffreeredh	de^sjiff^ree^redh
desjiffreeredh	de^sjiff^ree^redh
deskondeeredh	des^kon^dee^redh
dessineeredh	des^si^nee^redh
destilleeredh	des^til^lee^redh
destrueeredh	dest^ru^ee^redh
destrueeredh	dest^ru^ee^redh
detaljeeredh	de^ta^ljee^redh
detasjeeredh	de^ta^sjee^redh
detasjeeredh	de^ta^sjee^redh
detoneeredh	de^to^nee^redh
devijeeredh	de^vi^jee^redh
devijeeredh	de^vi^jee^redh
dibrehtalledh	dib^reh^tal^ledh
dibrehtistedh	dib^reh^tis^tedh
dibrelostedh	dib^re^los^tedh
diedtesovvedh	died^te^sov^vedh
diejviedestedh	diej^vie^des^tedh
dievviedestedh	diev^vie^des^tedh
differeeredh	dif^fe^ree^redh
diffundeeredh	dif^fun^dee^redh
diftongeeredh	dif^to^ngee^redh
dimitteeredh	di^mit^tee^redh
dirigeeredh	di^ri^gee^redh
disenteeredh	di^sen^tee^redh
diskonteeredh	dis^kon^tee^redh
diskuteeredh	dis^ku^tee^redh
dispasjeeredh	dis^pa^sjee^redh
dispasjeeredh	dis^pa^sjee^redh
dispenseeredh	dis^pen^see^redh
disponeeredh	dis^po^nee^redh
disputeeredh	dis^pu^tee^redh
dissekeeredh	dis^se^kee^redh
dissenteeredh	dis^sen^tee^redh
dissoneeredh	dis^so^nee^redh
distanseeredh	dis^tan^see^redh
distingveeredh	dis^ting^vee^redh
distraheeredh	dist^ra^hee^redh
divergeeredh	di^ver^gee^redh
diverteeredh	di^ver^tee^redh
divideeredh	di^vi^dee^redh
doebpehtalledh	doeb^peh^tal^ledh
doeltijahtjedh	doel^ti^jah^tjedh
doeltijehtedh	doel^ti^jeh^tedh
doengehtehtedh	doe^ngeh^teh^tedh
dogkestalledh	dog^kes^tal^ledh
doktoreeredh	dok^to^ree^redh
domhpelgovvedh	domh^pel^gov^vedh
domineeredh	do^mi^nee^redh
domperostedh	dom^pe^ros^tedh
domtesadtedh	dom^te^sad^tedh
dongkesovvedh	dong^ke^sov^vedh
dorjehtalledh	dor^jeh^tal^ledh
dorjesovvedh	dor^je^sov^vedh
dovhkerdalledh	dovh^ker^dal^ledh
dovvesovvedh	dov^ve^sov^vedh
dupliseeredh	dup^li^see^redh
dupliseeredh	dup^li^see^redh
dygkedadtedh	dyg^ke^dad^tedh
dyvvesovvedh	dyv^ve^sov^vedh
dyödedehtedh	dyö^de^deh^tedh
dyöredehtedh	dyö^re^deh^tedh
dåadtjadalledh	dåad^tja^dal^ledh
dåadtjedalledh	dåad^tje^dal^ledh
dåajvoehtistedh	dåaj^voeh^tis^tedh
dåalmehtalledh	dåal^meh^tal^ledh
dåalmehtovvedh	dåal^meh^tov^vedh
dåalvoejahtjedh	dåal^voe^jah^tjedh
dåaradalledh	dåa^ra^dal^ledh
dåararadtedh	dåa^ra^rad^tedh
dåhkasjehtedh	dåh^ka^sjeh^tedh
dååbpestehtedh	dååb^pes^teh^tedh
dååjelovvedh	dåå^je^lov^vedh
dååjestalledh	dåå^jes^tal^ledh
dååjvehtalledh	dååj^veh^tal^ledh
dåålvedadtedh	dåål^ve^dad^tedh
dåålvedahtedh	dåål^ve^dah^tedh
dåålvesovvedh	dåål^ve^sov^vedh
dåårestalledh	dåå^res^tal^ledh
dåårijadtedh	dåå^ri^jad^tedh
dåårjehtalledh	dåår^jeh^tal^ledh
dååstehtalledh	dåås^teh^tal^ledh
dæljoedehtedh	dæ^ljoe^deh^tedh
dïeblestehtedh	dïeb^les^teh^tedh
dïebpehtalledh	dïeb^peh^tal^ledh
dïebtjestehtedh	dïeb^tjes^teh^tedh
dïedtelgovvedh	dïed^tel^gov^vedh
dïelmehtalledh	dïel^meh^tal^ledh
dïelmestehtedh	dïel^mes^teh^tedh
dïemtjestehtedh	dïem^tjes^teh^tedh
dïenehtalledh	dïe^neh^tal^ledh
dïenesjadtedh	dïe^ne^sjad^tedh
dïerehtalledh	dïe^reh^tal^ledh
dïpmijahtjedh	dïp^mi^jah^tjedh
dööhtjeradtedh	dööh^tje^rad^tedh
dööpmesovvedh	dööp^me^sov^vedh
dööresmehtedh	döö^res^meh^tedh
eabnadehtedh	eab^na^deh^tedh
eadtjaldehtedh	ead^tjal^deh^tedh
eadtjaldovvedh	ead^tjal^dov^vedh
eadtjalgehtedh	ead^tjal^geh^tedh
eadtjalgovvedh	ead^tjal^gov^vedh
eajhkaldehtedh	eajh^kal^deh^tedh
eajhnadovvedh	eajh^na^dov^vedh
eajmadalledh	eaj^ma^dal^ledh
eajparostedh	eaj^pa^ros^tedh
eaktjaldehtedh	eak^tjal^deh^tedh
eaktjalostedh	eak^tja^los^tedh
ealjahtalledh	ea^ljah^tal^ledh
easalovvedh	ea^sa^lov^vedh
eatjahtehtedh	ea^tjah^teh^tedh
eatjahtovvedh	ea^tjah^tov^vedh
eatjkaldehtedh	eatj^kal^deh^tedh
eatjkalostedh	eatj^ka^los^tedh
eejehtalledh	ee^jeh^tal^ledh
eelesovvedh	ee^le^sov^vedh
eksegeeredh	ek^se^gee^redh
eksegeeredh	ek^se^gee^redh
eksekveeredh	ek^se^kvee^redh
eksekveeredh	ek^se^kvee^redh
ekselleeredh	ek^sel^lee^redh
ekselleeredh	ek^sel^lee^redh
ekserpeeredh	ek^ser^pee^redh
ekserpeeredh	ek^ser^pee^redh
ekserseeredh	ek^ser^see^redh
ekserseeredh	ek^ser^see^redh
ekserseeredh	ek^ser^see^redh
ekserseeredh	ek^ser^see^redh
ekshaleeredh	ek^sha^lee^redh
ekshaleeredh	ek^sha^lee^redh
eksisteeredh	ek^sis^tee^redh
eksisteeredh	ek^sis^tee^redh
eksklameeredh	eks^kla^mee^redh
eksklameeredh	eks^kla^mee^redh
ekskludeeredh	eks^klu^dee^redh
ekskludeeredh	eks^klu^dee^redh
ekspandeeredh	ek^span^dee^redh
ekspandeeredh	ek^span^dee^redh
ekspedeeredh	ek^spe^dee^redh
ekspedeeredh	ek^spe^dee^redh
ekspireeredh	ek^spi^ree^redh
ekspireeredh	ek^spi^ree^redh
eksplodeeredh	eksp^lo^dee^redh
eksplodeeredh	eksp^lo^dee^redh
eksponeeredh	ek^spo^nee^redh
eksponeeredh	ek^spo^nee^redh
eksporteeredh	ek^spor^tee^redh
eksporteeredh	ek^spor^tee^redh
ekstendeeredh	ek^sten^dee^redh
ekstendeeredh	ek^sten^dee^redh
ekstraheeredh	ekst^ra^hee^redh
ekstraheeredh	ekst^ra^hee^redh
ekvipeeredh	e^kvi^pee^redh
eleveeredh	e^le^vee^redh
eligeeredh	e^li^gee^redh
elokseeredh	e^lok^see^redh
elokseeredh	e^lok^see^redh
eludeeredh	e^lu^dee^redh
emaljeeredh	e^ma^ljee^redh
emballeeredh	em^bal^lee^redh
embarkeeredh	em^bar^kee^redh
emigreeredh	e^mig^ree^redh
emitteeredh	e^mit^tee^redh
employeeredh	emp^lo^yee^redh
emuleeredh	e^mu^lee^redh
emulgeeredh	e^mul^gee^redh
endosseeredh	en^dos^see^redh
enerveeredh	e^ner^vee^redh
engasjeeredh	e^nga^sjee^redh
ensileeredh	en^si^lee^redh
erigeeredh	e^ri^gee^redh
erodeeredh	e^ro^dee^redh
eskaleeredh	es^ka^lee^redh
eskapeeredh	es^ka^pee^redh
eskorteeredh	es^kor^tee^redh
estimeeredh	es^ti^mee^redh
etableeredh	e^tab^lee^redh
faarhmestalledh	faarh^mes^tal^ledh
fabrikeeredh	fab^ri^kee^redh
fabrikkeeredh	fab^rik^kee^redh
fabuleeredh	fa^bu^lee^redh
faerhmiestalledh	faerh^mies^tal^ledh
fahkajovvedh	fah^ka^jov^vedh
faktureeredh	fak^tu^ree^redh
fantaseeredh	fan^ta^see^redh
fantiseeredh	fan^ti^see^redh
fasetteeredh	fa^set^tee^redh
fasjineeredh	fa^sji^nee^redh
fasjineeredh	fa^sji^nee^redh
fasongeeredh	fa^so^ngee^redh
feahtaskehtedh	feah^tas^keh^tedh
ferieeredh	fe^ri^ee^redh
fermenteeredh	fer^men^tee^redh
fernisseeredh	fer^nis^see^redh
ferriedahtjedh	fer^rie^dah^tjedh
figureeredh	fi^gu^ree^redh
fileteeredh	fi^le^tee^redh
fisjoneeredh	fi^sjo^nee^redh
fissjerdehtedh	fis^sjer^deh^tedh
fluktueeredh	fluk^tu^ee^redh
fluktueeredh	fluk^tu^ee^redh
fokuseeredh	fo^ku^see^redh
folijeeredh	fo^li^jee^redh
folijeeredh	fo^li^jee^redh
formateeredh	for^ma^tee^redh
formuleeredh	for^mu^lee^redh
fragmenteeredh	frag^men^tee^redh
fraksjoneeredh	frak^sjo^nee^redh
frekventeeredh	fre^kven^tee^redh
froskestalledh	fros^kes^tal^ledh
fuamahkehtedh	fua^mah^keh^tedh
fulkesadtedh	ful^ke^sad^tedh
furageeredh	fu^ra^gee^redh
furasjeeredh	fu^ra^sjee^redh
fusjoneeredh	fu^sjo^nee^redh
fyödedalledh	fyö^de^dal^ledh
fyödtelgovvedh	fyöd^tel^gov^vedh
fåårhmestalledh	fåårh^mes^tal^ledh
fååtesmovvedh	fåå^tes^mov^vedh
fæjloedehtedh	fæj^loe^deh^tedh
fïedtelgovvedh	fïed^tel^gov^vedh
fïelestalledh	fïe^les^tal^ledh
fïeskesjistedh	fïes^ke^sjis^tedh
fïjnehtistedh	fïj^neh^tis^tedh
fïjneldehtedh	fïj^nel^deh^tedh
fïrnestehtedh	fïr^nes^teh^tedh
föörhkestehtedh	föörh^kes^teh^tedh
gaagnadehtedh	gaag^na^deh^tedh
gaagnijdehtedh	gaag^nij^deh^tedh
gaahtestalledh	gaah^tes^tal^ledh
gaajegadtedh	gaa^je^gad^tedh
gaajegostedh	gaa^je^gos^tedh
gaajegovvedh	gaa^je^gov^vedh
gaajmerostedh	gaaj^me^ros^tedh
gaakasadtedh	gaa^ka^sad^tedh
gaalkasjehtedh	gaal^ka^sjeh^tedh
gaalnijïhtjedh	gaal^ni^jïh^tjedh
gaamhparadtedh	gaamh^pa^rad^tedh
gaamhparestedh	gaamh^pa^res^tedh
gaamhparostedh	gaamh^pa^ros^tedh
gaanedehtedh	gaa^ne^deh^tedh
gaarastalledh	gaa^ras^tal^ledh
gaarehtjadtedh	gaa^reh^tjad^tedh
gaarhkelovvedh	gaarh^ke^lov^vedh
gaarhtalostedh	gaarh^ta^los^tedh
gaarkehtalledh	gaar^keh^tal^ledh
gaarkehtovvedh	gaar^keh^tov^vedh
gaarngegostedh	gaar^nge^gos^tedh
gaarnjarostedh	gaar^nja^ros^tedh
gaarsjaldovvedh	gaar^sjal^dov^vedh
gaartalovvedh	gaar^ta^lov^vedh
gaarvanadtedh	gaar^va^nad^tedh
gaastastalledh	gaas^tas^tal^ledh
gaatelassjedh	gaa^te^las^sjedh
gaatskehtjistedh	gaats^keh^tjis^tedh
gaavestalledh	gaa^ves^tal^ledh
gabpalostedh	gab^pa^los^tedh
gabralostedh	gab^ra^los^tedh
gabrarostedh	gab^ra^ros^tedh
gadtalgoevedh	gad^tal^goe^vedh
gadtalgovvedh	gad^tal^gov^vedh
gadtastalledh	gad^tas^tal^ledh
gadtastoevedh	gad^tas^toe^vedh
gadtastovvedh	gad^tas^tov^vedh
gadtehtjadtedh	gad^teh^tjad^tedh
gadteladtedh	gad^te^lad^tedh
gadtsehtistedh	gad^tseh^tis^tedh
gaerviehtestedh	gaer^vieh^tes^tedh
gagnijdehtedh	gag^nij^deh^tedh
gahtjedadtedh	gah^tje^dad^tedh
gahtjedestedh	gah^tje^des^tedh
gajhkalostedh	gajh^ka^los^tedh
gajhkedistedh	gajh^ke^dis^tedh
gajhkehtestedh	gajh^keh^tes^tedh
gajhkeldehtedh	gajh^kel^deh^tedh
gajhkeloevedh	gajh^ke^loe^vedh
gajhkelovvedh	gajh^ke^lov^vedh
gajhkestehtedh	gajh^kes^teh^tedh
gajkerdalledh	gaj^ker^dal^ledh
gajmarostedh	gaj^ma^ros^tedh
gajmerostedh	gaj^me^ros^tedh
galhkasovvedh	galh^ka^sov^vedh
galhparostedh	galh^pa^ros^tedh
galhpestalledh	galh^pes^tal^ledh
gallamdehtedh	gal^lam^deh^tedh
gallanehtedh	gal^la^neh^tedh
galmadehtedh	gal^ma^deh^tedh
galmarehtedh	gal^ma^reh^tedh
galoppeeredh	ga^lop^pee^redh
gamhparostedh	gamh^pa^ros^tedh
gamkalostedh	gam^ka^los^tedh
gamkarostedh	gam^ka^ros^tedh
gangkerdalledh	gang^ker^dal^ledh
gapmanestedh	gap^ma^nes^tedh
gapmardalledh	gap^mar^dal^ledh
gapmarostedh	gap^ma^ros^tedh
gaptjedistedh	gap^tje^dis^tedh
gaptjelostedh	gap^tje^los^tedh
gaptjesostedh	gap^tje^sos^tedh
garanteeredh	ga^ran^tee^redh
garhkastehtedh	garh^kas^teh^tedh
garmarostedh	gar^ma^ros^tedh
garmelostedh	gar^me^los^tedh
garmerdalledh	gar^mer^dal^ledh
garmerdehtedh	gar^mer^deh^tedh
garparostedh	gar^pa^ros^tedh
gaskesadtedh	gas^ke^sad^tedh
gaskestalledh	gas^kes^tal^ledh
gaskijïhtjedh	gas^ki^jïh^tjedh
gavlahtoevedh	gav^lah^toe^vedh
gavlaskoevedh	gav^las^koe^vedh
gavverdistedh	gav^ver^dis^tedh
geajlastehtedh	geaj^las^teh^tedh
gealkamadtedh	geal^ka^mad^tedh
geanghkestalledh	geangh^kes^tal^ledh
gearamdehtedh	gea^ram^deh^tedh
gearmadalledh	gear^ma^dal^ledh
geasadovvedh	gea^sa^dov^vedh
geasalgovvedh	gea^sal^gov^vedh
geasastehtedh	gea^sas^teh^tedh
geasehtjadtedh	gea^seh^tjad^tedh
geatskedehtedh	geats^ke^deh^tedh
geehtesalledh	geeh^te^sal^ledh
geerehtalledh	gee^reh^tal^ledh
geerkehtehtedh	geer^keh^teh^tedh
geervedovvedh	geer^ve^dov^vedh
gejhkielistedh	gejh^kie^lis^tedh
genereeredh	ge^ne^ree^redh
giebrelgovvedh	gieb^rel^gov^vedh
giesiedovvedh	gie^sie^dov^vedh
gihtjeldehtedh	gih^tjel^deh^tedh
gihtjesovvedh	gih^tje^sov^vedh
gilmedehtedh	gil^me^deh^tedh
gobpestalledh	gob^pes^tal^ledh
goedehtjadtedh	goe^deh^tjad^tedh
goedeladtedh	goe^de^lad^tedh
goejedadtedh	goe^je^dad^tedh
goelperostedh	goel^pe^ros^tedh
goeredehtedh	goe^re^deh^tedh
goerehtalledh	goe^reh^tal^ledh
goerehtehtedh	goe^reh^teh^tedh
goerehtjadtedh	goe^reh^tjad^tedh
goerkelehtedh	goer^ke^leh^tedh
goerkesadtedh	goer^ke^sad^tedh
goerkestehtedh	goer^kes^teh^tedh
goerpedehtedh	goer^pe^deh^tedh
goeveldovvedh	goe^vel^dov^vedh
goevelsovvedh	goe^vel^sov^vedh
gohtjesovvedh	goh^tje^sov^vedh
gojhkelovvedh	gojh^ke^lov^vedh
gojhkelovvedh	gojh^ke^lov^vedh
golhpestalledh	golh^pes^tal^ledh
golkehtovvedh	gol^keh^tov^vedh
golteladtedh	gol^te^lad^tedh
gomperdalledh	gom^per^dal^ledh
gomtjelostedh	gom^tje^los^tedh
gopmesjadtedh	gop^me^sjad^tedh
gorredovvedh	gor^re^dov^vedh
gosseldehtedh	gos^sel^deh^tedh
govhkehtalledh	govh^keh^tal^ledh
govlehtalledh	gov^leh^tal^ledh
govlehtehtedh	gov^leh^teh^tedh
govlehtoevedh	gov^leh^toe^vedh
govlesadtedh	gov^le^sad^tedh
govleskoedtedh	gov^les^koed^tedh
govlesovvedh	gov^le^sov^vedh
gradueeredh	gra^du^ee^redh
granuleeredh	gra^nu^lee^redh
gratineeredh	gra^ti^nee^redh
gratuleeredh	gra^tu^lee^redh
graviteeredh	gra^vi^tee^redh
guaktastalledh	guak^tas^tal^ledh
guarkajahtjedh	guar^ka^jah^tjedh
guarparostedh	guar^pa^ros^tedh
guassadalledh	guas^sa^dal^ledh
guassastalledh	guas^sas^tal^ledh
guhkiedistedh	guh^kie^dis^tedh
gujmiebarkedh	guj^mie^bar^kedh
gujnestehtedh	guj^nes^teh^tedh
gummieeredh	gum^mi^ee^redh
gyhtjemovvedh	gyh^tje^mov^vedh
gyjhtelassjedh	gyjh^te^las^sjedh
gyjmedehtedh	gyj^me^deh^tedh
gylhkerdalledh	gylh^ker^dal^ledh
gyllerdalledh	gyl^ler^dal^ledh
gylpestalledh	gyl^pes^tal^ledh
gynhtserostedh	gynht^se^ros^tedh
gyrredalledh	gyr^re^dal^ledh
gyskesjadtedh	gys^ke^sjad^tedh
gyssedehtedh	gys^se^deh^tedh
györjesjadtedh	györ^je^sjad^tedh
gyösedehtedh	gyö^se^deh^tedh
gåadadehtedh	gåa^da^deh^tedh
gåajparostedh	gåaj^pa^ros^tedh
gåajstasovvedh	gåaj^sta^sov^vedh
gåajstehtjadtedh	gåaj^steh^tjad^tedh
gåarahtehtedh	gåa^rah^teh^tedh
gåarehtjadtedh	gåa^reh^tjad^tedh
gåartarehtedh	gåar^ta^reh^tedh
gåavnahtehtedh	gåav^nah^teh^tedh
gåavvarostedh	gåav^va^ros^tedh
gåeskiestehtedh	gåes^kies^teh^tedh
gåhkasjïhtjedh	gåh^ka^sjïh^tjedh
gåhtsajehtedh	gåh^tsa^jeh^tedh
gåjjahtehtedh	gåj^jah^teh^tedh
gåjmarostedh	gåj^ma^ros^tedh
gålkajdovvedh	gål^kaj^dov^vedh
gålnjesadtedh	gål^nje^sad^tedh
gåmhpadalledh	gåmh^pa^dal^ledh
gåpmanestedh	gåp^ma^nes^tedh
gåpmardalledh	gåp^mar^dal^ledh
gårkastehtedh	går^kas^teh^tedh
gåvlahtovvedh	gåv^lah^tov^vedh
gåvloehtovvedh	gåv^loeh^tov^vedh
gåvnahtalledh	gåv^nah^tal^ledh
gåvnahtehtedh	gåv^nah^teh^tedh
gåvnjeradtedh	gåv^nje^rad^tedh
gåvnjerdalledh	gåv^njer^dal^ledh
gåvverdistedh	gåv^ver^dis^tedh
gååjpestehtedh	gååj^pes^teh^tedh
gååmhperostedh	gååmh^pe^ros^tedh
gååredalledh	gåå^re^dal^ledh
gååresoevedh	gåå^re^soe^vedh
gååresoevvedh	gåå^re^soev^vedh
gååresovvedh	gåå^re^sov^vedh
gåårtesadtedh	gåår^te^sad^tedh
gåårvedestedh	gåår^ve^des^tedh
gåårvehtistedh	gåår^veh^tis^tedh
gååvnesovvedh	gååv^ne^sov^vedh
gæjmarostedh	gæj^ma^ros^tedh
gæjrarostedh	gæj^ra^ros^tedh
gæknjalostedh	gæk^nja^los^tedh
gïeblestehtedh	gïeb^les^teh^tedh
gïebreloevedh	gïeb^re^loe^vedh
gïebrelostedh	gïeb^re^los^tedh
gïebrelovvedh	gïeb^re^lov^vedh
gïehtjeladtedh	gïeh^tje^lad^tedh
gïelehtovvedh	gïe^leh^tov^vedh
gïelkerdalledh	gïel^ker^dal^ledh
gïemerdalledh	gïe^mer^dal^ledh
gïemerostedh	gïe^me^ros^tedh
gïerehtehtedh	gïe^reh^teh^tedh
gïerehtoevedh	gïe^reh^toe^vedh
gïerehtovvedh	gïe^reh^tov^vedh
gïerestalledh	gïe^res^tal^ledh
gïetedalledh	gïe^te^dal^ledh
gïevredehtedh	gïev^re^deh^tedh
gïjredehtedh	gïj^re^deh^tedh
gïknjeldovvedh	gïk^njel^dov^vedh
gïknjelostedh	gïk^nje^los^tedh
gïllerdalledh	gïl^ler^dal^ledh
gïrresalledh	gïr^re^sal^ledh
gïtnjelostedh	gït^nje^los^tedh
haajpanestedh	haaj^pa^nes^tedh
haajpenestedh	haaj^pe^nes^tedh
haalahtalledh	haa^lah^tal^ledh
haarmestovvedh	haar^mes^tov^vedh
haasegåetedh	haa^se^gåe^tedh
haavtaradtedh	haav^ta^rad^tedh
haavtarehtedh	haav^ta^reh^tedh
haavtarostedh	haav^ta^ros^tedh
hahtesadtedh	hah^te^sad^tedh
hajkedovvedh	haj^ke^dov^vedh
hajkegåetedh	haj^ke^gåe^tedh
hajkejahtjedh	haj^ke^jah^tjedh
hajkeldehtedh	haj^kel^deh^tedh
hajkijahtjedh	haj^ki^jah^tjedh
hajkijïhtjedh	haj^ki^jïh^tjedh
hajnarostedh	haj^na^ros^tedh
hapkadehtedh	hap^ka^deh^tedh
hapsahtalledh	hap^sah^tal^ledh
harmoneeredh	har^mo^nee^redh
harpeseeredh	har^pe^see^redh
harpuneeredh	har^pu^nee^redh
harrestalledh	har^res^tal^ledh
harseleeredh	har^se^lee^redh
havareeredh	ha^va^ree^redh
heajadoevedh	hea^ja^doe^vedh
heajadovvedh	hea^ja^dov^vedh
heajhkaldehtedh	heajh^kal^deh^tedh
hearaldehtedh	hea^ral^deh^tedh
heekedalledh	hee^ke^dal^ledh
heeledovvedh	hee^le^dov^vedh
heermedalledh	heer^me^dal^ledh
heermestalledh	heer^mes^tal^ledh
heerredoevedh	heer^re^doe^vedh
heerresovvedh	heer^re^sov^vedh
herpeseeredh	her^pe^see^redh
hohkehtehtedh	hoh^keh^teh^tedh
hohtehtjadtedh	hoh^teh^tjad^tedh
hojjedadtedh	hoj^je^dad^tedh
hojjedehtedh	hoj^je^deh^tedh
hojjestalledh	hoj^jes^tal^ledh
holvesadtedh	hol^ve^sad^tedh
honoreeredh	ho^no^ree^redh
hospiteeredh	hos^pi^tee^redh
hovmedadtedh	hov^me^dad^tedh
hujjestalledh	huj^jes^tal^ledh
hulkesadtedh	hul^ke^sad^tedh
hurvehtalledh	hur^veh^tal^ledh
hyörhkedalledh	hyörh^ke^dal^ledh
hyörhkestalledh	hyörh^kes^tal^ledh
hyörskedalledh	hyör^ske^dal^ledh
håhtasadtedh	håh^ta^sad^tedh
håhtastehtedh	håh^tas^teh^tedh
håjnarostedh	håj^na^ros^tedh
hålvesadtedh	hål^ve^sad^tedh
håågkedadtedh	hååg^ke^dad^tedh
hååjpedalledh	hååj^pe^dal^ledh
hååjsehtalledh	hååj^seh^tal^ledh
hååmestalledh	håå^mes^tal^ledh
hïehkehtalledh	hïeh^keh^tal^ledh
hïehpehtalledh	hïeh^peh^tal^ledh
hïerpehtehtedh	hïer^peh^teh^tedh
hïspehtehtedh	hïs^peh^teh^tedh
ierngiehtistedh	ier^ngieh^tis^tedh
ignoreeredh	ig^no^ree^redh
illesovvedh	il^le^sov^vedh
illudeeredh	il^lu^dee^redh
illustreeredh	il^lust^ree^redh
imiteeredh	i^mi^tee^redh
immigreeredh	im^mig^ree^redh
implanteeredh	imp^lan^tee^redh
impliseeredh	imp^li^see^redh
impliseeredh	imp^li^see^redh
implodeeredh	imp^lo^dee^redh
imponeeredh	im^po^nee^redh
importeeredh	im^por^tee^redh
impregneeredh	imp^reg^nee^redh
indekseeredh	in^dek^see^redh
indikeeredh	in^di^kee^redh
induseeredh	in^du^see^redh
induseeredh	in^du^see^redh
infameeredh	in^fa^mee^redh
infiltreeredh	in^filt^ree^redh
infiseeredh	in^fi^see^redh
infiseeredh	in^fi^see^redh
inflammeeredh	inf^lam^mee^redh
inflateeredh	inf^la^tee^redh
influeeredh	inf^lu^ee^redh
influeeredh	inf^lu^ee^redh
informeeredh	in^for^mee^redh
inhaleeredh	in^ha^lee^redh
inhereeredh	in^he^ree^redh
inhibeeredh	in^hi^bee^redh
injiseeredh	i^nji^see^redh
injiseeredh	i^nji^see^redh
inkarneeredh	in^kar^nee^redh
inkludeeredh	in^klu^dee^redh
insisteeredh	in^sis^tee^redh
insiteeredh	in^si^tee^redh
insiteeredh	in^si^tee^redh
inspekteeredh	in^spek^tee^redh
inspireeredh	in^spi^ree^redh
inspiseeredh	in^spi^see^redh
installeeredh	in^stal^lee^redh
instrueeredh	inst^ru^ee^redh
instrueeredh	inst^ru^ee^redh
integreeredh	in^teg^ree^redh
intendeeredh	in^ten^dee^redh
interneeredh	in^ter^nee^redh
intoneeredh	in^to^nee^redh
intresseeredh	int^res^see^redh
intrigeeredh	int^ri^gee^redh
invadeeredh	in^va^dee^redh
inventeeredh	in^ven^tee^redh
inverteeredh	in^ver^tee^redh
investeeredh	in^ves^tee^redh
inviteeredh	in^vi^tee^redh
involveeredh	in^vol^vee^redh
ioniseeredh	io^ni^see^redh
irhkesovvedh	irh^ke^sov^vedh
iriseeredh	i^ri^see^redh
irrigeeredh	ir^ri^gee^redh
irriteeredh	ir^ri^tee^redh
isoleeredh	i^so^lee^redh
itereeredh	i^te^ree^redh
jaadtamdalledh	jaad^tam^dal^ledh
jaamaldovvedh	jaa^mal^dov^vedh
jaamalgehtedh	jaa^mal^geh^tedh
jaamalgoevedh	jaa^mal^goe^vedh
jaamalgovvedh	jaa^mal^gov^vedh
jalkedehtedh	jal^ke^deh^tedh
jallanestedh	jal^la^nes^tedh
jamhkarostedh	jamh^ka^ros^tedh
jamhkehtjadtedh	jamh^keh^tjad^tedh
jammarostedh	jam^ma^ros^tedh
jardineeredh	jar^di^nee^redh
jarkeldehtedh	jar^kel^deh^tedh
jarkelehtedh	jar^ke^leh^tedh
jarkerostedh	jar^ke^ros^tedh
jarkoestehtedh	jar^koes^teh^tedh
jarparostedh	jar^pa^ros^tedh
jarperdalledh	jar^per^dal^ledh
jarreldehtedh	jar^rel^deh^tedh
jarrelostedh	jar^re^los^tedh
jastehtjadtedh	jas^teh^tjad^tedh
jeahkaldehtedh	jeah^kal^deh^tedh
jeahtasovvedh	jeah^ta^sov^vedh
jealadehtedh	jea^la^deh^tedh
jealajehtedh	jea^la^jeh^tedh
jealehtjadtedh	jea^leh^tjad^tedh
jeammarostedh	jeam^ma^ros^tedh
jeatjahtehtedh	jea^tjah^teh^tedh
jeatjahtovvedh	jea^tjah^tov^vedh
jiekiestehtedh	jie^kies^teh^tedh
jiermiehtoevedh	jier^mieh^toe^vedh
jiermiehtovvedh	jier^mieh^tov^vedh
jissiehtehtedh	jis^sieh^teh^tedh
jodiseeredh	jo^di^see^redh
joejkedalledh	joej^ke^dal^ledh
joejkijïhtjedh	joej^ki^jïh^tjedh
joekehtadtedh	joe^keh^tad^tedh
joekehtehtedh	joe^keh^teh^tedh
joekehtestedh	joe^keh^tes^tedh
joevenadtedh	joe^ve^nad^tedh
joevjemdalledh	joev^jem^dal^ledh
joksedestedh	jok^se^des^tedh
joksedistedh	jok^se^dis^tedh
joptsestehtedh	jop^tses^teh^tedh
jorkesestedh	jor^ke^ses^tedh
jorkestovvedh	jor^kes^tov^vedh
jorpenadtedh	jor^pe^nad^tedh
jovjemdalledh	jov^jem^dal^ledh
jovkehtehtedh	jov^keh^teh^tedh
jovkestalledh	jov^kes^tal^ledh
juakasovvedh	jua^ka^sov^vedh
juakasovvedh	jua^ka^sov^vedh
jubileeredh	ju^bi^lee^redh
jurjiehtistedh	jur^jieh^tis^tedh
juryeeredh	ju^ry^ee^redh
juryeeredh	ju^ry^ee^redh
jyönesstehtedh	jyö^nes^steh^tedh
jyötjedehtedh	jyö^tje^deh^tedh
jåarhkasovvedh	jåarh^ka^sov^vedh
jåaskarehtedh	jåas^ka^reh^tedh
jåaskoedehtedh	jåas^koe^deh^tedh
jårraldalledh	jår^ral^dal^ledh
jårraldehtedh	jår^ral^deh^tedh
jårregåetedh	jår^re^gåe^tedh
jårrehtehtedh	jår^reh^teh^tedh
jårrelostedh	jår^re^los^tedh
jåvkedistedh	jåv^ke^dis^tedh
jåvkelistedh	jåv^ke^lis^tedh
jæjhtahtalledh	jæjh^tah^tal^ledh
jïebnesjadtedh	jïeb^ne^sjad^tedh
jïejkegåetedh	jïej^ke^gåe^tedh
jïelehtadtjedh	jïe^leh^tad^tjedh
jïengedestedh	jïe^nge^des^tedh
jïengerestedh	jïe^nge^res^tedh
jïepkerostedh	jïep^ke^ros^tedh
jïeptergoevedh	jïep^ter^goe^vedh
jïeptergovvedh	jïep^ter^gov^vedh
jïermestalledh	jïer^mes^tal^ledh
jïjjedoevedh	jïj^je^doe^vedh
jïjjedovvedh	jïj^je^dov^vedh
jïjjehtoevedh	jïj^jeh^toe^vedh
jïjjehtovvedh	jïj^jeh^tov^vedh
jïjtjereeredh	jïj^tje^ree^redh
jïrresovvedh	jïr^re^sov^vedh
kadmijeeredh	kad^mi^jee^redh
kadmijeeredh	kad^mi^jee^redh
kalandreeredh	ka^land^ree^redh
kalibreeredh	ka^lib^ree^redh
kalkuleeredh	kal^ku^lee^redh
kalkyleeredh	kal^ky^lee^redh
kalsineeredh	kal^si^nee^redh
kamufleeredh	ka^muf^lee^redh
kandideeredh	kan^di^dee^redh
kandiseeredh	kan^di^see^redh
kanneleeredh	kan^ne^lee^redh
kanselleeredh	kan^sel^lee^redh
kapuneeredh	ka^pu^nee^redh
karikeeredh	ka^ri^kee^redh
kartoneeredh	kar^to^nee^redh
klieniedehtedh	klie^nie^deh^tedh
klientiseeredh	klien^ti^see^redh
klitnjiedehtedh	klit^njie^deh^tedh
klovperostedh	klov^pe^ros^tedh
klygkerostedh	klyg^ke^ros^tedh
klåvparostedh	klåv^pa^ros^tedh
klååmsehtalledh	klååm^seh^tal^ledh
koketteeredh	ko^ket^tee^redh
kokkeleeredh	kok^ke^lee^redh
kokkeleeredh	kok^ke^lee^redh
kokkereeredh	kok^ke^ree^redh
kollideeredh	kol^li^dee^redh
kollokveeredh	kol^lo^kvee^redh
koloreeredh	ko^lo^ree^redh
kolporteeredh	kol^por^tee^redh
komfirmeeredh	kom^fir^mee^redh
kommandeeredh	kom^man^dee^redh
kommendeeredh	kom^men^dee^redh
kommenteeredh	kom^men^tee^redh
kommuteeredh	kom^mu^tee^redh
kompareeredh	kom^pa^ree^redh
kompenseeredh	kom^pen^see^redh
kompileeredh	kom^pi^lee^redh
kompletteeredh	komp^let^tee^redh
kompliseeredh	komp^li^see^redh
kompliseeredh	komp^li^see^redh
komponeeredh	kom^po^nee^redh
komposteeredh	kom^pos^tee^redh
komprimeeredh	komp^ri^mee^redh
kondemneeredh	kon^dem^nee^redh
kondenseeredh	kon^den^see^redh
kondoleeredh	kon^do^lee^redh
konfereeredh	kon^fe^ree^redh
konfirmeeredh	kon^fir^mee^redh
konfiskeeredh	kon^fis^kee^redh
konfronteeredh	konf^ron^tee^redh
kongrueeredh	kong^ru^ee^redh
kongrueeredh	kong^ru^ee^redh
konjugeeredh	ko^nju^gee^redh
konkludeeredh	kon^klu^dee^redh
konkurreeredh	kon^kur^ree^redh
konnoteeredh	kon^no^tee^redh
konsentreeredh	kon^sent^ree^redh
konsentreeredh	kon^sent^ree^redh
konserteeredh	kon^ser^tee^redh
konserveeredh	kon^ser^vee^redh
konsigneeredh	kon^sig^nee^redh
konsipeeredh	kon^si^pee^redh
konskribeeredh	kons^kri^bee^redh
konspireeredh	kon^spi^ree^redh
konstateeredh	kon^sta^tee^redh
konstrueeredh	konst^ru^ee^redh
konstrueeredh	konst^ru^ee^redh
konsulteeredh	kon^sul^tee^redh
kontraheeredh	kont^ra^hee^redh
kontrasteeredh	kont^ras^tee^redh
kontrolleeredh	kont^rol^lee^redh
konvergeeredh	kon^ver^gee^redh
konverseeredh	kon^ver^see^redh
konverteeredh	kon^ver^tee^redh
konvoieeredh	kon^vo^iee^redh
konvojeeredh	kon^vo^jee^redh
kopijeeredh	ko^pi^jee^redh
kopijeeredh	ko^pi^jee^redh
kopuleeredh	ko^pu^lee^redh
korreleeredh	kor^re^lee^redh
korrigeeredh	kor^ri^gee^redh
korrodeeredh	kor^ro^dee^redh
korrugeeredh	kor^ru^gee^redh
krakeleeredh	kra^ke^lee^redh
krakkeleeredh	krak^ke^lee^redh
krakkeleeredh	krak^ke^lee^redh
krakngarostedh	krak^nga^ros^tedh
kramhkestehtedh	kramh^kes^teh^tedh
kranhtjarostedh	kranht^ja^ros^tedh
krediteeredh	kre^di^tee^redh
kreneleeredh	kre^ne^lee^redh
krimmiehtehtedh	krim^mieh^teh^tedh
krimmiehtoevedh	krim^mieh^toe^vedh
kristeldehtedh	kris^tel^deh^tedh
kristesehtedh	kris^te^seh^tedh
kristesoevedh	kris^te^soe^vedh
kristesovvedh	kris^te^sov^vedh
kritiseeredh	kri^ti^see^redh
kroehkestalledh	kroeh^kes^tal^ledh
krokngeradtedh	krok^nge^rad^tedh
krokngerostedh	krok^nge^ros^tedh
kronikkeeredh	kro^nik^kee^redh
krunhtjeladtedh	krunht^je^lad^tedh
kråavhtjestehtedh	kråavht^jes^teh^tedh
kråavvardalledh	kråav^var^dal^ledh
kråavvarostedh	kråav^va^ros^tedh
kråånhtestalledh	kråånh^tes^tal^ledh
krååvvehtalledh	krååv^veh^tal^ledh
krååvverdalledh	krååv^ver^dal^ledh
krænhtjarostedh	krænht^ja^ros^tedh
krïtnegåetedh	krït^ne^gåe^tedh
krönikeeredh	krö^ni^kee^redh
kröövvehtalledh	krööv^veh^tal^ledh
kujoneeredh	ku^jo^nee^redh
kulmineeredh	kul^mi^nee^redh
kultiveeredh	kul^ti^vee^redh
kumuleeredh	ku^mu^lee^redh
kurateeredh	ku^ra^tee^redh
kursiveeredh	kur^si^vee^redh
kurtiseeredh	kur^ti^see^redh
kvantiteeredh	kvan^ti^tee^redh
kveruleeredh	kve^ru^lee^redh
laadtadovvedh	laad^ta^dov^vedh
laadtajdehtedh	laad^taj^deh^tedh
laadtajdovvedh	laad^taj^dov^vedh
laagkastalledh	laag^kas^tal^ledh
laatjoestehtedh	laa^tjoes^teh^tedh
laavenjostedh	laa^ve^njos^tedh
laavkedehtedh	laav^ke^deh^tedh
laavlijïhtjedh	laav^li^jïh^tjedh
laehkiehtehtedh	laeh^kieh^teh^tedh
lahtestehtedh	lah^tes^teh^tedh
laskajdehtedh	las^kaj^deh^tedh
leajpaskovvedh	leaj^pas^kov^vedh
leammamadtedh	leam^ma^mad^tedh
leerhkehtalledh	leerh^keh^tal^ledh
levereeredh	le^ve^ree^redh
liehtestehtedh	lieh^tes^teh^tedh
lijrehtistedh	lij^reh^tis^tedh
likvideeredh	li^kvi^dee^redh
lisiteeredh	li^si^tee^redh
loebpedehtedh	loeb^pe^deh^tedh
loehtjehtalledh	loeh^tjeh^tal^ledh
lokngedadtedh	lok^nge^dad^tedh
lokngesovvedh	lok^nge^sov^vedh
lombardeeredh	lom^bar^dee^redh
lorgnetteeredh	lorg^net^tee^redh
lovterdehtedh	lov^ter^deh^tedh
luajhtasovvedh	luajh^ta^sov^vedh
lustedalledh	lus^te^dal^ledh
lustestalledh	lus^tes^tal^ledh
lutnjiesovvedh	lut^njie^sov^vedh
lyhpehtalledh	lyh^peh^tal^ledh
lyjhkesadtedh	lyjh^ke^sad^tedh
lyjjestalledh	lyj^jes^tal^ledh
lynghkijadtedh	lyngh^ki^jad^tedh
lyögamadtedh	lyö^ga^mad^tedh
låabtadehtedh	låab^ta^deh^tedh
låamedestedh	låa^me^des^tedh
låamtadehtedh	låam^ta^deh^tedh
låasehtalledh	låa^seh^tal^ledh
låvnesalledh	låv^ne^sal^ledh
lååjedehtedh	låå^je^deh^tedh
lååjjedehtedh	lååj^je^deh^tedh
lååvkesovvedh	lååv^ke^sov^vedh
læjnoedehtedh	læj^noe^deh^tedh
læmmamadtedh	læm^ma^mad^tedh
lïegkedadtedh	lïeg^ke^dad^tedh
lïegkedestedh	lïeg^ke^des^tedh
lïegkestadtedh	lïeg^kes^tad^tedh
lïenedehtedh	lïe^ne^deh^tedh
lïenegåetedh	lïe^ne^gåe^tedh
lïenijahtjedh	lïe^ni^jah^tjedh
lïerehtalledh	lïe^reh^tal^ledh
lïerhvehtalledh	lïerh^veh^tal^ledh
lïetsedehtedh	lïe^tse^deh^tedh
lïgkedadtedh	lïg^ke^dad^tedh
lïjmedalledh	lïj^me^dal^ledh
maahtjardalledh	maah^tjar^dal^ledh
maajverostedh	maaj^ve^ros^tedh
maakestehtedh	maa^kes^teh^tedh
maanadovvedh	maa^na^dov^vedh
maatadadtedh	maa^ta^dad^tedh
maatadistedh	maa^ta^dis^tedh
maatsijahtjedh	maa^tsi^jah^tjedh
madtahtoevedh	mad^tah^toe^vedh
madtarostedh	mad^ta^ros^tedh
madtjeldehtedh	mad^tjel^deh^tedh
madtjelostedh	mad^tje^los^tedh
madtjelovvedh	mad^tje^lov^vedh
magkahtalledh	mag^kah^tal^ledh
magkaldehtedh	mag^kal^deh^tedh
magkalostedh	mag^ka^los^tedh
magkaradtedh	mag^ka^rad^tedh
magkarostedh	mag^ka^ros^tedh
mahkeldehtedh	mah^kel^deh^tedh
mahterdehtedh	mah^ter^deh^tedh
mahtjalostedh	mah^tja^los^tedh
maksimeeredh	mak^si^mee^redh
maksimeeredh	mak^si^mee^redh
makuleeredh	ma^ku^lee^redh
maljarostedh	ma^lja^ros^tedh
mallerdehtedh	mal^ler^deh^tedh
maltrakteeredh	malt^rak^tee^redh
mannadalledh	man^na^dal^ledh
manövreeredh	ma^növ^ree^redh
manøvreeredh	ma^nøv^ree^redh
marineeredh	ma^ri^nee^redh
marmoreeredh	mar^mo^ree^redh
marredovvedh	mar^re^dov^vedh
marrehtovvedh	mar^reh^tov^vedh
marvelostedh	mar^ve^los^tedh
maskineeredh	mas^ki^nee^redh
massakreeredh	mas^sa^kree^redh
masturbeeredh	mas^tur^bee^redh
meajvadovvedh	meaj^va^dov^vedh
mealtjehtehtedh	meal^tjeh^teh^tedh
mealtjestehtedh	meal^tjes^teh^tedh
mearhkelgoevedh	mearh^kel^goe^vedh
measehtjadtedh	mea^seh^tjad^tedh
meavradehtedh	meav^ra^deh^tedh
meavrarehtedh	meav^ra^reh^tedh
mediteeredh	me^di^tee^redh
meksiehtestedh	mek^sieh^tes^tedh
memoreeredh	me^mo^ree^redh
menstrueeredh	menst^ru^ee^redh
menstrueeredh	menst^ru^ee^redh
meriteeredh	me^ri^tee^redh
meritteeredh	me^rit^tee^redh
minimeeredh	mi^ni^mee^redh
misjoneeredh	mi^sjo^nee^redh
modelleeredh	mo^del^lee^redh
modereeredh	mo^de^ree^redh
moduleeredh	mo^du^lee^redh
moenesovvedh	moe^ne^sov^vedh
moenjehtehtedh	moe^njeh^teh^tedh
moevelostedh	moe^ve^los^tedh
mohtjelostedh	moh^tje^los^tedh
mohtjelovvedh	moh^tje^lov^vedh
mojhteladtedh	mojh^te^lad^tedh
mojhtestehtedh	mojh^tes^teh^tedh
mojjehtalledh	moj^jeh^tal^ledh
mojnestehtedh	moj^nes^teh^tedh
molesteeredh	mo^les^tee^redh
molsesovvedh	mol^se^sov^vedh
molsestalledh	mol^ses^tal^ledh
mosjoneeredh	mo^sjo^nee^redh
moskestehtedh	mos^kes^teh^tedh
motiveeredh	mo^ti^vee^redh
mousseeredh	mo^us^see^redh
movhkestalledh	movh^kes^tal^ledh
muahrastehtedh	muah^ras^teh^tedh
muavastehtedh	mua^vas^teh^tedh
mujhtiegåetedh	mujh^tie^gåe^tedh
mulliedistedh	mul^lie^dis^tedh
mulliemdestedh	mul^liem^des^tedh
mumiseeredh	mu^mi^see^redh
munnedalledh	mun^ne^dal^ledh
murriedehtedh	mur^rie^deh^tedh
musiseeredh	mu^si^see^redh
musiseeredh	mu^si^see^redh
myvhkedehtedh	myvh^ke^deh^tedh
myörhkelgovvedh	myörh^kel^gov^vedh
myövhkedehtedh	myövh^ke^deh^tedh
måahtsehtalledh	måah^tseh^tal^ledh
måakoehtehtedh	måa^koeh^teh^tedh
måaradehtedh	måa^ra^deh^tedh
måaradoevedh	måa^ra^doe^vedh
måarahtehtedh	måa^rah^teh^tedh
måarahtovvedh	måa^rah^tov^vedh
måarahtovvedh	måa^rah^tov^vedh
måaroedovvedh	måa^roe^dov^vedh
måasadovvedh	måa^sa^dov^vedh
måasardehtedh	måa^sar^deh^tedh
måaskadehtedh	måas^ka^deh^tedh
måbpastovvedh	måb^pas^tov^vedh
mådtahtovvedh	måd^tah^tov^vedh
mådtarostedh	måd^ta^ros^tedh
måjhtadistedh	måjh^ta^dis^tedh
måjhtajehtedh	måjh^ta^jeh^tedh
målhtjardehtedh	målht^jar^deh^tedh
mårverostedh	mår^ve^ros^tedh
måvradehtedh	måv^ra^deh^tedh
måårngestehtedh	måår^nges^teh^tedh
mååserehtedh	måå^se^reh^tedh
mïehtsijahtjedh	mïeh^tsi^jah^tjedh
mïelegåetedh	mïe^le^gåe^tedh
mïeltjestehtedh	mïel^tjes^teh^tedh
mïerhkelgovvedh	mïerh^kel^gov^vedh
mïetskedehtedh	mïets^ke^deh^tedh
mïnnegåetedh	mïn^ne^gåe^tedh
mïrrestalledh	mïr^res^tal^ledh
nahkalostedh	nah^ka^los^tedh
nahkerdovvedh	nah^ker^dov^vedh
nahkesalledh	nah^ke^sal^ledh
nahkestehtedh	nah^kes^teh^tedh
nahkestestedh	nah^kes^tes^tedh
najveldehtedh	naj^vel^deh^tedh
nallahtalledh	nal^lah^tal^ledh
nallarostedh	nal^la^ros^tedh
nasaleeredh	na^sa^lee^redh
nastehtehtedh	nas^teh^teh^tedh
navigeeredh	na^vi^gee^redh
nearrarostedh	near^ra^ros^tedh
neelelgovvedh	nee^lel^gov^vedh
negligeeredh	neg^li^gee^redh
neglisjeeredh	neg^li^sjee^redh
nihkierdoevedh	nih^kier^doe^vedh
nihkierdovvedh	nih^kier^dov^vedh
nihkiergoevedh	nih^kier^goe^vedh
nihtetjistedh	nih^te^tjis^tedh
nivelleeredh	ni^vel^lee^redh
njaabpehtalledh	njaab^peh^tal^ledh
njaamegåetedh	njaa^me^gåe^tedh
njaarehtehtedh	njaa^reh^teh^tedh
njaarkenadtedh	njaar^ke^nad^tedh
njaarkesedtedh	njaar^ke^sed^tedh
njahpalostedh	njah^pa^los^tedh
njavtahtalledh	njav^tah^tal^ledh
njavvarostedh	njav^va^ros^tedh
njealtahtalledh	njeal^tah^tal^ledh
njealtehtjadtedh	njeal^teh^tjad^tedh
njeervedovvedh	njeer^ve^dov^vedh
njeevhresovvedh	njeevh^re^sov^vedh
njeevhrijahtjedh	njeevh^ri^jah^tjedh
njiervehtehtedh	njier^veh^teh^tedh
njoejjegåetedh	njoej^je^gåe^tedh
njojjehtalledh	njoj^jeh^tal^ledh
njulhtjestalledh	njulht^jes^tal^ledh
njyjjehtalledh	njyj^jeh^tal^ledh
njyörtijahtjedh	njyör^ti^jah^tjedh
njåajjarostedh	njåaj^ja^ros^tedh
njåamasalledh	njåa^ma^sal^ledh
njåatjoedistedh	njåa^tjoe^dis^tedh
njåavvarehtedh	njåav^va^reh^tedh
njåavvarostedh	njåav^va^ros^tedh
njåvtahtalledh	njåv^tah^tal^ledh
njåvtasovvedh	njåv^ta^sov^vedh
njåånehtalledh	njåå^neh^tal^ledh
njåånestehtedh	njåå^nes^teh^tedh
njæssjoedahtjedh	njæs^sjoe^dah^tjedh
njïehtsehtjadtedh	njïeh^tseh^tjad^tedh
njïssijahtjedh	njïs^si^jah^tjedh
njöömkehtalledh	njööm^keh^tal^ledh
njöönehtalledh	njöö^neh^tal^ledh
njöönestehtedh	njöö^nes^teh^tedh
noeresovvedh	noe^re^sov^vedh
noerhkestehtedh	noerh^kes^teh^tedh
nojvenadtedh	noj^ve^nad^tedh
noljedestedh	no^lje^des^tedh
noljedistedh	no^lje^dis^tedh
nollehtalledh	nol^leh^tal^ledh
nomhpelovvedh	nomh^pe^lov^vedh
nomineeredh	no^mi^nee^redh
nommedehtedh	nom^me^deh^tedh
nommestehtedh	nom^mes^teh^tedh
nonsjaleeredh	non^sja^lee^redh
nonsjaleeredh	non^sja^lee^redh
norresovvedh	nor^re^sov^vedh
novvegåetedh	nov^ve^gåe^tedh
nummereeredh	num^me^ree^redh
nyanseeredh	ny^an^see^redh
nydtehtalledh	nyd^teh^tal^ledh
nåagkoedehtedh	nåag^koe^deh^tedh
nåarastehtedh	nåa^ras^teh^tedh
nåhkedadtedh	nåh^ke^dad^tedh
nållagovvedh	nål^la^gov^vedh
nållarostedh	nål^la^ros^tedh
nållaskovvedh	nål^las^kov^vedh
nååjtestalledh	nååj^tes^tal^ledh
nåårvehtjadtedh	nåår^veh^tjad^tedh
nååtestehtedh	nåå^tes^teh^tedh
nïejtestalledh	nïej^tes^tal^ledh
nïelehtovvedh	nïe^leh^tov^vedh
nïerredehtedh	nïer^re^deh^tedh
nïhpesjahtjedh	nïh^pe^sjah^tjedh
nïhtehtjistedh	nïh^teh^tjis^tedh
nïrredehtedh	nïr^re^deh^tedh
obduseeredh	ob^du^see^redh
obduseeredh	ob^du^see^redh
obredadtedh	ob^re^dad^tedh
obrijahtjedh	ob^ri^jah^tjedh
observeeredh	ob^ser^vee^redh
obstrueeredh	obst^ru^ee^redh
obstrueeredh	obst^ru^ee^redh
offereeredh	of^fe^ree^redh
ogkehtalledh	og^keh^tal^ledh
ohtseldehtedh	oh^tsel^deh^tedh
okkulteeredh	ok^kul^tee^redh
okkulteeredh	ok^kul^tee^redh
okkupeeredh	ok^ku^pee^redh
okkupeeredh	ok^ku^pee^redh
oksideeredh	ok^si^dee^redh
oksideeredh	ok^si^dee^redh
oksydeeredh	ok^sy^dee^redh
okuleeredh	o^ku^lee^redh
onaneeredh	o^na^nee^redh
onduleeredh	on^du^lee^redh
opereeredh	o^pe^ree^redh
opmedadtedh	op^me^dad^tedh
opponeeredh	op^po^nee^redh
optimeeredh	op^ti^mee^redh
ordineeredh	or^di^nee^redh
orienteeredh	o^rien^tee^redh
orkestreeredh	or^kest^ree^redh
orpedalledh	or^pe^dal^ledh
orrijadtedh	or^ri^jad^tedh
oskilleeredh	os^kil^lee^redh
oskilleeredh	os^kil^lee^redh
ostedalledh	os^te^dal^ledh
paahkanadtedh	paah^ka^nad^tedh
pagineeredh	pa^gi^nee^redh
palleteeredh	pal^le^tee^redh
panoreeredh	pa^no^ree^redh
paradeeredh	pa^ra^dee^redh
parafeeredh	pa^ra^fee^redh
parfymeeredh	par^fy^mee^redh
parregåetedh	par^re^gåe^tedh
parselleeredh	par^sel^lee^redh
parselleeredh	par^sel^lee^redh
passiveeredh	pas^si^vee^redh
patenteeredh	pa^ten^tee^redh
patineeredh	pa^ti^nee^redh
patruljeeredh	pat^ru^ljee^redh
patrulleeredh	pat^rul^lee^redh
pauseeredh	pa^u^see^redh
pelleteeredh	pel^le^tee^redh
penetreeredh	pe^net^ree^redh
pensjoneeredh	pen^sjo^nee^redh
perenneeredh	pe^ren^nee^redh
perforeeredh	per^fo^ree^redh
perkoleeredh	per^ko^lee^redh
perkuteeredh	per^ku^tee^redh
permitteeredh	per^mit^tee^redh
permuteeredh	per^mu^tee^redh
persifleeredh	per^sif^lee^redh
persisteeredh	per^sis^tee^redh
perspireeredh	per^spi^ree^redh
perturbeeredh	per^tur^bee^redh
perverteeredh	per^ver^tee^redh
pigmenteeredh	pig^men^tee^redh
piruetteeredh	pi^ruet^tee^redh
plaavedehtedh	plaa^ve^deh^tedh
plagijeeredh	pla^gi^jee^redh
plagijeeredh	pla^gi^jee^redh
platineeredh	pla^ti^nee^redh
pleavvastalledh	pleav^vas^tal^ledh
pleehtjestehtedh	pleeh^tjes^teh^tedh
plievviestalledh	pliev^vies^tal^ledh
plinhtjestalledh	plinht^jes^tal^ledh
plogkedehtedh	plog^ke^deh^tedh
plogkegehtedh	plog^ke^geh^tedh
plogkesovvedh	plog^ke^sov^vedh
pluntehtehtedh	plun^teh^teh^tedh
plyjkestalledh	plyj^kes^tal^ledh
plyjkestalledh	plyj^kes^tal^ledh
plyöhkedehtedh	plyöh^ke^deh^tedh
plyöjhkedehtedh	plyöjh^ke^deh^tedh
plïehtjestehtedh	plïeh^tjes^teh^tedh
plïetjestehtedh	plïe^tjes^teh^tedh
poetiseeredh	poe^ti^see^redh
pokuleeredh	po^ku^lee^redh
porsjoneeredh	por^sjo^nee^redh
portretteeredh	port^ret^tee^redh
porträtteeredh	port^rät^tee^redh
postdateeredh	post^da^tee^redh
postuleeredh	pos^tu^lee^redh
potenseeredh	po^ten^see^redh
poängteeredh	po^äng^tee^redh
praahkajdalledh	praah^kaj^dal^ledh
praahkardalledh	praah^kar^dal^ledh
praahkasadtedh	praah^ka^sad^tedh
praktiseeredh	prak^ti^see^redh
predikeeredh	pre^di^kee^redh
prefereeredh	pre^fe^ree^redh
prekaveeredh	pre^ka^vee^redh
preludeeredh	pre^lu^dee^redh
premijeeredh	pre^mi^jee^redh
premijeeredh	pre^mi^jee^redh
prepareeredh	pre^pa^ree^redh
presenteeredh	pre^sen^tee^redh
preserveeredh	pre^ser^vee^redh
presideeredh	pre^si^dee^redh
presiseeredh	pre^si^see^redh
presiseeredh	pre^si^see^redh
preskribeeredh	pres^kri^bee^redh
pretendeeredh	pre^ten^dee^redh
produseeredh	pro^du^see^redh
produseeredh	pro^du^see^redh
profeteeredh	pro^fe^tee^redh
profileeredh	pro^fi^lee^redh
profiteeredh	pro^fi^tee^redh
profitteeredh	pro^fit^tee^redh
prognoseeredh	prog^no^see^redh
programmeeredh	prog^ram^mee^redh
projekteeredh	pro^jek^tee^redh
projiseeredh	pro^ji^see^redh
proklameeredh	pro^kla^mee^redh
prolongeeredh	pro^lo^ngee^redh
promoveeredh	pro^mo^vee^redh
promulgeeredh	pro^mul^gee^redh
propageeredh	pro^pa^gee^redh
proponeeredh	pro^po^nee^redh
prosedeeredh	pro^se^dee^redh
prosedeeredh	pro^se^dee^redh
prosesseeredh	pro^ses^see^redh
prosesseeredh	pro^ses^see^redh
prosjekteeredh	pro^sjek^tee^redh
proskribeeredh	pros^kri^bee^redh
prospekteeredh	pros^pek^tee^redh
protegeeredh	pro^te^gee^redh
protesjeeredh	pro^te^sjee^redh
protesteeredh	pro^tes^tee^redh
provhkelgoevedh	provh^kel^goe^vedh
provhkesovvedh	provh^ke^sov^vedh
provideeredh	pro^vi^dee^redh
provoseeredh	pro^vo^see^redh
provvehtalledh	prov^veh^tal^ledh
pruvrehtehtedh	pruv^reh^teh^tedh
pruvvedadtedh	pruv^ve^dad^tedh
publiseeredh	pub^li^see^redh
publiseeredh	pub^li^see^redh
påasarostedh	påa^sa^ros^tedh
raadaguedtedh	raa^da^gued^tedh
raajkadalledh	raaj^ka^dal^ledh
raajkanadtedh	raaj^ka^nad^tedh
raakedehtedh	raa^ke^deh^tedh
raakerehtedh	raa^ke^reh^tedh
raarahtalledh	raa^rah^tal^ledh
raarastalledh	raa^ras^tal^ledh
raavkedehtedh	raav^ke^deh^tedh
rabatteeredh	ra^bat^tee^redh
radijeeredh	ra^di^jee^redh
radijeeredh	ra^di^jee^redh
raeriehtovvedh	rae^rieh^tov^vedh
rahperdehtedh	rah^per^deh^tedh
ramponeeredh	ram^po^nee^redh
raporteeredh	ra^por^tee^redh
rappelleeredh	rap^pel^lee^redh
rapporteeredh	rap^por^tee^redh
rarhmadehtedh	rarh^ma^deh^tedh
rarhmarostedh	rarh^ma^ros^tedh
rasjoneeredh	ra^sjo^nee^redh
raskehtalledh	ras^keh^tal^ledh
rastadehtedh	ras^ta^deh^tedh
ratnestehtedh	rat^nes^teh^tedh
ravrastalledh	rav^ras^tal^ledh
reakadehtedh	rea^ka^deh^tedh
reakasoevedh	rea^ka^soe^vedh
reakasovvedh	rea^ka^sov^vedh
reakastoevedh	rea^kas^toe^vedh
reaktiveeredh	reak^ti^vee^redh
realiseeredh	rea^li^see^redh
reassureeredh	reas^su^ree^redh
rebelleeredh	re^bel^lee^redh
rebpieldovvedh	reb^piel^dov^vedh
redigeeredh	re^di^gee^redh
reduseeredh	re^du^see^redh
reduseeredh	re^du^see^redh
reegkestehtedh	reeg^kes^teh^tedh
reejregåetedh	reej^re^gåe^tedh
reesmesovvedh	rees^me^sov^vedh
refereeredh	re^fe^ree^redh
reflekteeredh	ref^lek^tee^redh
reformeeredh	re^for^mee^redh
refundeeredh	re^fun^dee^redh
refuseeredh	re^fu^see^redh
regaleeredh	re^ga^lee^redh
regisseeredh	re^gis^see^redh
registreeredh	re^gist^ree^redh
reguleeredh	re^gu^lee^redh
regummeeredh	re^gum^mee^redh
rejiseeredh	re^ji^see^redh
reklameeredh	re^kla^mee^redh
rekreeeredh	re^kre^ee^redh
rekruteeredh	re^kru^tee^redh
rekrutteeredh	re^krut^tee^redh
rekryteeredh	re^kry^tee^redh
rekvireeredh	re^kvi^ree^redh
relateeredh	re^la^tee^redh
relegeeredh	re^le^gee^redh
relokeeredh	re^lo^kee^redh
remburseeredh	rem^bur^see^redh
remiseeredh	re^mi^see^redh
remiteeredh	re^mi^tee^redh
remitteeredh	re^mit^tee^redh
remonteeredh	re^mon^tee^redh
remplasseeredh	remp^las^see^redh
renonseeredh	re^non^see^redh
renoveeredh	re^no^vee^redh
repareeredh	re^pa^ree^redh
repeteeredh	re^pe^tee^redh
repliseeredh	rep^li^see^redh
repliseeredh	rep^li^see^redh
reporteeredh	re^por^tee^redh
resenseeredh	re^sen^see^redh
resenseeredh	re^sen^see^redh
reserveeredh	re^ser^vee^redh
resideeredh	re^si^dee^redh
resigneeredh	re^sig^nee^redh
resipeeredh	re^si^pee^redh
resisteeredh	re^sis^tee^redh
resiteeredh	re^si^tee^redh
resiteeredh	re^si^tee^redh
resolveeredh	re^sol^vee^redh
resoneeredh	re^so^nee^redh
resonneeredh	re^son^nee^redh
resorbeeredh	re^sor^bee^redh
respekteeredh	res^pek^tee^redh
respireeredh	res^pi^ree^redh
respondeeredh	res^pon^dee^redh
restiedehtedh	res^tie^deh^tedh
restiemdehtedh	res^tiem^deh^tedh
resulteeredh	re^sul^tee^redh
retardeeredh	re^tar^dee^redh
retineeredh	re^ti^nee^redh
retireeredh	re^ti^ree^redh
returneeredh	re^tur^nee^redh
retusjeeredh	re^tu^sjee^redh
retusjeeredh	re^tu^sjee^redh
revansjeeredh	re^van^sjee^redh
revansjeeredh	re^van^sjee^redh
reverseeredh	re^ver^see^redh
revideeredh	re^vi^dee^redh
revolteeredh	re^vol^tee^redh
riegkiegåetedh	rieg^kie^gåe^tedh
rihkijahtjedh	rih^ki^jah^tjedh
riposteeredh	ri^pos^tee^redh
risikeeredh	ri^si^kee^redh
ristorneeredh	ris^tor^nee^redh
robkehtalledh	rob^keh^tal^ledh
roehkenstehtedh	roeh^ken^steh^tedh
roehtestalledh	roeh^tes^tal^ledh
roehtestehtedh	roeh^tes^teh^tedh
roehtsestehtedh	roeh^tses^teh^tedh
roejestehtedh	roe^jes^teh^tedh
rohkelassjedh	roh^ke^las^sjedh
rohpesadtedh	roh^pe^sad^tedh
rokkestalledh	rok^kes^tal^ledh
rokkestalledh	rok^kes^tal^ledh
romkehtalledh	rom^keh^tal^ledh
rontestalledh	ron^tes^tal^ledh
rovrestalledh	rov^res^tal^ledh
ruarmedehtedh	ruar^me^deh^tedh
rubriseeredh	rub^ri^see^redh
rubriseeredh	rub^ri^see^redh
ruineeredh	ru^i^nee^redh
ryöjredestedh	ryöj^re^des^tedh
ryöredestedh	ryö^re^des^tedh
råanjijahtjedh	råa^nji^jah^tjedh
råaparostedh	råa^pa^ros^tedh
råassjoedehtedh	råas^sjoe^deh^tedh
råatnjegåetedh	råat^nje^gåe^tedh
råavegåetedh	råa^ve^gåe^tedh
råådesjadtedh	råå^de^sjad^tedh
råådtjestalledh	rååd^tjes^tal^ledh
råågkestehtedh	rååg^kes^teh^tedh
rååjverostedh	rååj^ve^ros^tedh
rååkehtalledh	råå^keh^tal^ledh
rååknedehtedh	rååk^ne^deh^tedh
rååresjadtedh	råå^re^sjad^tedh
råårestalledh	råå^res^tal^ledh
ræssoedadtedh	ræs^soe^dad^tedh
rïddesadtedh	rïd^de^sad^tedh
rïddesestedh	rïd^de^ses^tedh
rïehpestalledh	rïeh^pes^tal^ledh
rïhpesovvedh	rïh^pe^sov^vedh
rïjtestalledh	rïj^tes^tal^ledh
rïrrelgovvedh	rïr^rel^gov^vedh
rïrresestedh	rïr^re^ses^tedh
rïrresjadtedh	rïr^re^sjad^tedh
rïrresjistedh	rïr^re^sjis^tedh
rïssedadtedh	rïs^se^dad^tedh
röövestalledh	röö^ves^tal^ledh
saadtesovvedh	saad^te^sov^vedh
saajenistedh	saa^je^nis^tedh
saajregadtedh	saaj^re^gad^tedh
saajroehtehtedh	saaj^roeh^teh^tedh
saaksedehtedh	saak^se^deh^tedh
saaksoedehtedh	saak^soe^deh^tedh
saalehtalledh	saa^leh^tal^ledh
saalvestehtedh	saal^ves^teh^tedh
saarnoegåetedh	saar^noe^gåe^tedh
saboteeredh	sa^bo^tee^redh
saejriedahtjedh	saej^rie^dah^tjedh
saeliehtalledh	sae^lieh^tal^ledh
sahherdehtedh	sah^her^deh^tedh
saknahtovvedh	sak^nah^tov^vedh
saluteeredh	sa^lu^tee^redh
salutteeredh	sa^lut^tee^redh
samparostedh	sam^pa^ros^tedh
sanksjoneeredh	sanks^jo^nee^redh
sarvasjadtedh	sar^va^sjad^tedh
satineeredh	sa^ti^nee^redh
savradehtedh	sav^ra^deh^tedh
sealadestedh	sea^la^des^tedh
sealarostedh	sea^la^ros^tedh
seasastehtedh	sea^sas^teh^tedh
seavahtalledh	sea^vah^tal^ledh
seerehtalledh	see^reh^tal^ledh
seereldehtedh	see^rel^deh^tedh
seevehtalledh	see^veh^tal^ledh
segmenteeredh	seg^men^tee^redh
segregeeredh	seg^re^gee^redh
sekniehtovvedh	sek^nieh^tov^vedh
seksjoneeredh	sek^sjo^nee^redh
sekundeeredh	se^kun^dee^redh
selebreeredh	se^leb^ree^redh
selebreeredh	se^leb^ree^redh
selekteeredh	se^lek^tee^redh
sementeeredh	se^men^tee^redh
sementeeredh	se^men^tee^redh
semineeredh	se^mi^nee^redh
sensureeredh	sen^su^ree^redh
sensureeredh	sen^su^ree^redh
separeeredh	se^pa^ree^redh
serkiestahtjedh	ser^kies^tah^tjedh
serrateeredh	ser^ra^tee^redh
sibjehtalledh	sib^jeh^tal^ledh
siejjiedehtedh	siej^jie^deh^tedh
sienhtegåetedh	sienh^te^gåe^tedh
signaleeredh	sig^na^lee^redh
siknjiedahtjedh	sik^njie^dah^tjedh
simuleeredh	si^mu^lee^redh
sirkuleeredh	sir^ku^lee^redh
sirkuleeredh	sir^ku^lee^redh
siseleeredh	si^se^lee^redh
siseleeredh	si^se^lee^redh
sjammadehtedh	sjam^ma^deh^tedh
sjamponeeredh	sjam^po^nee^redh
sjamponeeredh	sjam^po^nee^redh
sjarkalostedh	sjar^ka^los^tedh
sjevroteeredh	sjev^ro^tee^redh
sjevroteeredh	sjev^ro^tee^redh
sjilkehtestedh	sjil^keh^tes^tedh
sjolhkesovvedh	sjolh^ke^sov^vedh
sjuahkadalledh	sjuah^ka^dal^ledh
sjuesjiedehtedh	sjue^sjie^deh^tedh
sjugniehtoevedh	sjug^nieh^toe^vedh
sjugniehtovvedh	sjug^nieh^tov^vedh
sjugniesovvedh	sjug^nie^sov^vedh
sjyjjedehtedh	sjyj^je^deh^tedh
sjyjjehtehtedh	sjyj^jeh^teh^tedh
sjyöhtesjadtedh	sjyöh^te^sjad^tedh
sjåavoehtestedh	sjåa^voeh^tes^tedh
sjåårkestalledh	sjåår^kes^tal^ledh
sjïehteladtedh	sjïeh^te^lad^tedh
sjïehtelestedh	sjïeh^te^les^tedh
sjïehtelovvedh	sjïeh^te^lov^vedh
sjïehtesjadtedh	sjïeh^te^sjad^tedh
skaamasadtedh	skaa^ma^sad^tedh
skaamasjadtedh	skaa^ma^sjad^tedh
skaamastalledh	skaa^mas^tal^ledh
skaemiegåetedh	skae^mie^gåe^tedh
skearkadehtedh	skear^ka^deh^tedh
skeepehtalledh	skee^peh^tal^ledh
skeletteeredh	ske^let^tee^redh
skjeletteeredh	skje^let^tee^redh
skodtedehtedh	skod^te^deh^tedh
skodteldehtedh	skod^tel^deh^tedh
skodtestalledh	skod^tes^tal^ledh
skohtelostedh	skoh^te^los^tedh
skompelostedh	skom^pe^los^tedh
skopmeldehtedh	skop^mel^deh^tedh
skovhtjijïhtjedh	skovht^ji^jïh^tjedh
skovtjerostedh	skov^tje^ros^tedh
skreejrehtovvedh	skreej^reh^tov^vedh
skroedtedehtedh	skroed^te^deh^tedh
skrovhpesjistedh	skrovh^pe^sjis^tedh
skubpelgovvedh	skub^pel^gov^vedh
skuekiersovvedh	skue^kier^sov^vedh
skvadroneeredh	skvad^ro^nee^redh
skygkerdalledh	skyg^ker^dal^ledh
skygkerostedh	skyg^ke^ros^tedh
skyllegåetedh	skyl^le^gåe^tedh
skïedtjestalledh	skïed^tjes^tal^ledh
skïjlijahtjedh	skïj^li^jah^tjedh
skïjmestalledh	skïj^mes^tal^ledh
slaajperostedh	slaaj^pe^ros^tedh
slaamkehtehtedh	slaam^keh^teh^tedh
slaamkerehtedh	slaam^ke^reh^tedh
slaerviedestedh	slaer^vie^des^tedh
slahtjegåetedh	slah^tje^gåe^tedh
slahtjehkehtedh	slah^tjeh^keh^tedh
slajkedalledh	slaj^ke^dal^ledh
slajkeldehtedh	slaj^kel^deh^tedh
slajparostedh	slaj^pa^ros^tedh
slearaskovvedh	slea^ras^kov^vedh
sleavvasjehtedh	sleav^va^sjeh^tedh
slohtijahtjedh	sloh^ti^jah^tjedh
slovvestalledh	slov^ves^tal^ledh
slïbnjerostedh	slïb^nje^ros^tedh
slïedtjedehtedh	slïed^tje^deh^tedh
slïedtjegoevedh	slïed^tje^goe^vedh
slïeteroesedh	slïe^te^roe^sedh
slïmpestalledh	slïm^pes^tal^ledh
slööptjegovvedh	slööp^tje^gov^vedh
smarkadalledh	smar^ka^dal^ledh
smohkestalledh	smoh^kes^tal^ledh
smååjlestalledh	smååj^les^tal^ledh
snahkarostedh	snah^ka^ros^tedh
snarhpadehtedh	snarh^pa^deh^tedh
snarrestehtedh	snar^res^teh^tedh
snekkereeredh	snek^ke^ree^redh
snjarhtjarostedh	snjarht^ja^ros^tedh
snjipkelovvedh	snjip^ke^lov^vedh
snjovtjegåetedh	snjov^tje^gåe^tedh
snjåapedehtedh	snjåa^pe^deh^tedh
snjåarhtjarostedh	snjåarht^ja^ros^tedh
snjïerpedehtedh	snjïer^pe^deh^tedh
snjïerpesostedh	snjïer^pe^sos^tedh
snjïerpestehtedh	snjïer^pes^teh^tedh
snohkehtjadtedh	snoh^keh^tjad^tedh
snovregåetedh	snov^re^gåe^tedh
snovsehtehtedh	snov^seh^teh^tedh
snyjhkehtalledh	snyjh^keh^tal^ledh
snåhkaradtedh	snåh^ka^rad^tedh
snåhkarostedh	snåh^ka^ros^tedh
snårhpoedehtedh	snårh^poe^deh^tedh
snårrestehtedh	snår^res^teh^tedh
snåvregåetedh	snåv^re^gåe^tedh
snåvrijïhtjedh	snåv^ri^jïh^tjedh
sobjenadtedh	sob^je^nad^tedh
sodtelehtedh	sod^te^leh^tedh
soebkedehtedh	soeb^ke^deh^tedh
soedtedehtedh	soed^te^deh^tedh
soeksegåetedh	soek^se^gåe^tedh
soeksijïhtjedh	soek^si^jïh^tjedh
soelkedehtedh	soel^ke^deh^tedh
soelkehtehtedh	soel^keh^teh^tedh
soelvehtalledh	soel^veh^tal^ledh
soemestehtedh	soe^mes^teh^tedh
soemkedehtedh	soem^ke^deh^tedh
soemkerehtedh	soem^ke^reh^tedh
soeredehtedh	soe^re^deh^tedh
soevedehtedh	soe^ve^deh^tedh
soevelgovvedh	soe^vel^gov^vedh
soevestehtedh	soe^ves^teh^tedh
sojjehtehtedh	soj^jeh^teh^tedh
solmiseeredh	sol^mi^see^redh
somperdehtedh	som^per^deh^tedh
soptsesovvedh	sop^tse^sov^vedh
soptsestalledh	sop^tses^tal^ledh
soptsestehtedh	sop^tses^teh^tedh
sovkijahtjedh	sov^ki^jah^tjedh
spaarradehtedh	spaar^ra^deh^tedh
spankuleeredh	span^ku^lee^redh
speelhkesadtedh	speelh^ke^sad^tedh
spekuleeredh	spe^ku^lee^redh
spioneeredh	spi^o^nee^redh
sponsoreeredh	spon^so^ree^redh
spraanhtehtehtedh	spraanh^teh^teh^tedh
sprahtestalledh	sprah^tes^tal^ledh
sprïjnehtehtedh	sprïj^neh^teh^tedh
sprïnterdehtedh	sprïn^ter^deh^tedh
spuallarehtedh	spual^la^reh^tedh
staampardehtedh	staam^par^deh^tedh
staamparostedh	staam^pa^ros^tedh
staatnehkehtedh	staat^neh^keh^tedh
stadtjasjadtedh	stad^tja^sjad^tedh
stagkaladtedh	stag^ka^lad^tedh
stantjelostedh	stan^tje^los^tedh
starnedehtedh	star^ne^deh^tedh
starnegåetedh	star^ne^gåe^tedh
stasjoneeredh	sta^sjo^nee^redh
statueeredh	sta^tu^ee^redh
statueeredh	sta^tu^ee^redh
stealladestedh	steal^la^des^tedh
steehpehtehtedh	steeh^peh^teh^tedh
steemhpedehtedh	steemh^pe^deh^tedh
stensileeredh	sten^si^lee^redh
stensileeredh	sten^si^lee^redh
stiehpegåetedh	stieh^pe^gåe^tedh
stiliseeredh	sti^li^see^redh
stimuleeredh	sti^mu^lee^redh
stinkestehtedh	stin^kes^teh^tedh
stipuleeredh	sti^pu^lee^redh
stirrelgåetedh	stir^rel^gåe^tedh
stoenehtehtedh	stoe^neh^teh^tedh
stoevedovvedh	stoe^ve^dov^vedh
stogkestalledh	stog^kes^tal^ledh
stolhtestalledh	stolh^tes^tal^ledh
stovhpijahtjedh	stovh^pi^jah^tjedh
straanjaldehtedh	straa^njal^deh^tedh
straatnjarostedh	straat^nja^ros^tedh
stranguleeredh	stra^ngu^lee^redh
streatjoegåetedh	strea^tjoe^gåe^tedh
strerkiestehtedh	strer^kies^teh^tedh
struarkastehtedh	struar^kas^teh^tedh
struktureeredh	struk^tu^ree^redh
strïetjegåetedh	strïe^tje^gåe^tedh
stuarasehtedh	stua^ra^seh^tedh
styöbnehtalledh	styöb^neh^tal^ledh
ståalijadtedh	ståa^li^jad^tedh
stååvtjerostedh	stååv^tje^ros^tedh
stæssardehtedh	stæs^sar^deh^tedh
stïehpegåetedh	stïeh^pe^gåe^tedh
stïssedehtedh	stïs^se^deh^tedh
stïsserdehtedh	stïs^ser^deh^tedh
stïsserostedh	stïs^se^ros^tedh
stöörelgovvedh	stöö^rel^gov^vedh
stöövedovvedh	stöö^ve^dov^vedh
sualalgoevedh	sua^lal^goe^vedh
sualasovvedh	sua^la^sov^vedh
subjehtalledh	sub^jeh^tal^ledh
subjehtjadtedh	sub^jeh^tjad^tedh
sublimeeredh	sub^li^mee^redh
subskribeeredh	subs^kri^bee^redh
subtraheeredh	subt^ra^hee^redh
suehpiedovvedh	sueh^pie^dov^vedh
suffigeeredh	suf^fi^gee^redh
suffikseeredh	suf^fik^see^redh
suggereeredh	sug^ge^ree^redh
suksedeeredh	suk^se^dee^redh
suksedeeredh	suk^se^dee^redh
supineeredh	su^pi^nee^redh
supplejeeredh	supp^le^jee^redh
supplejeeredh	supp^le^jee^redh
supplikeeredh	supp^li^kee^redh
supplikeeredh	supp^li^kee^redh
supplikkeeredh	supp^lik^kee^redh
supponeeredh	sup^po^nee^redh
supprimeeredh	supp^ri^mee^redh
suspendeeredh	sus^pen^dee^redh
suvriedehtedh	suv^rie^deh^tedh
suvriedistedh	suv^rie^dis^tedh
svaaktjestalledh	svaak^tjes^tal^ledh
svalkarostedh	sval^ka^ros^tedh
svijregåetedh	svij^re^gåe^tedh
sviktjerdalledh	svik^tjer^dal^ledh
svinhtehtalledh	svinh^teh^tal^ledh
svitjkerdalledh	svitj^ker^dal^ledh
svyjhkehtalledh	svyjh^keh^tal^ledh
svållarostedh	svål^la^ros^tedh
svååjpelostedh	svååj^pe^los^tedh
svïjhkehtalledh	svïjh^keh^tal^ledh
svïktjerdalledh	svïk^tjer^dal^ledh
syjledehtedh	syj^le^deh^tedh
synkopeeredh	syn^ko^pee^redh
syöjkedalledh	syöj^ke^dal^ledh
syöjkedehtedh	syöj^ke^deh^tedh
syölkeldehtedh	syöl^kel^deh^tedh
såabrarostedh	såab^ra^ros^tedh
såajjoedehtedh	såaj^joe^deh^tedh
såakadehtedh	såa^ka^deh^tedh
såakarehtedh	såa^ka^reh^tedh
såakoedehtedh	såa^koe^deh^tedh
såaraskehtedh	såa^ras^keh^tedh
såarastehtedh	såa^ras^teh^tedh
såbrarostedh	såb^ra^ros^tedh
såstahtalledh	sås^tah^tal^ledh
såvroedehtedh	såv^roe^deh^tedh
såågkestehtedh	sååg^kes^teh^tedh
sååjteladtedh	sååj^te^lad^tedh
såålemehtedh	såå^le^meh^tedh
såålhtesovvedh	såålh^te^sov^vedh
såålvestalledh	såål^ves^tal^ledh
såårkestalledh	såår^kes^tal^ledh
sæjlarehtedh	sæj^la^reh^tedh
sæjloedehtedh	sæj^loe^deh^tedh
sæjloedestedh	sæj^loe^des^tedh
sæljadehtedh	sæ^lja^deh^tedh
sïedtelgovvedh	sïed^tel^gov^vedh
sïedtjehtovvedh	sïed^tjeh^tov^vedh
sïejegåetedh	sïe^je^gåe^tedh
sïejkedalledh	sïej^ke^dal^ledh
sïektedehtedh	sïek^te^deh^tedh
sïerrestalledh	sïer^res^tal^ledh
sïessestalledh	sïes^ses^tal^ledh
sïevehtalledh	sïe^veh^tal^ledh
sïjregåetedh	sïj^re^gåe^tedh
sïmmedadtedh	sïm^me^dad^tedh
tabuleeredh	ta^bu^lee^redh
tadterostedh	tad^te^ros^tedh
tapetseeredh	ta^pe^tsee^redh
tapiseeredh	ta^pi^see^redh
tatoveeredh	ta^to^vee^redh
tatueeredh	ta^tu^ee^redh
tatueeredh	ta^tu^ee^redh
teehpehtalledh	teeh^peh^tal^ledh
tekstureeredh	tek^stu^ree^redh
tekstureeredh	tek^stu^ree^redh
telekseeredh	te^lek^see^redh
telekseeredh	te^lek^see^redh
tempereeredh	tem^pe^ree^redh
terrasseeredh	ter^ras^see^redh
tituleeredh	ti^tu^lee^redh
tjaabrestehtedh	tjaab^res^teh^tedh
tjaabroehtistedh	tjaab^roeh^tis^tedh
tjaahpajdovvedh	tjaah^paj^dov^vedh
tjaajalgoevedh	tjaa^jal^goe^vedh
tjaajalgovvedh	tjaa^jal^gov^vedh
tjaajalostedh	tjaa^ja^los^tedh
tjaajanestedh	tjaa^ja^nes^tedh
tjaalasovvedh	tjaa^la^sov^vedh
tjaalehtjadtedh	tjaa^leh^tjad^tedh
tjaangesalledh	tjaa^nge^sal^ledh
tjaarahtalledh	tjaa^rah^tal^ledh
tjaarastoevedh	tjaa^ras^toe^vedh
tjaarhvahtalledh	tjaarh^vah^tal^ledh
tjaatsalgovvedh	tjaa^tsal^gov^vedh
tjaatsestalledh	tjaa^tses^tal^ledh
tjaeliedehtedh	tjae^lie^deh^tedh
tjaeliehtehtedh	tjae^lieh^teh^tedh
tjaffedehtedh	tjaf^fe^deh^tedh
tjagkaladtedh	tjag^ka^lad^tedh
tjagkarostedh	tjag^ka^ros^tedh
tjagkeradtedh	tjag^ke^rad^tedh
tjagkesalledh	tjag^ke^sal^ledh
tjahkalostedh	tjah^ka^los^tedh
tjahkanestedh	tjah^ka^nes^tedh
tjahkasjadtedh	tjah^ka^sjad^tedh
tjahkeldalledh	tjah^kel^dal^ledh
tjaktjedovvedh	tjak^tje^dov^vedh
tjalhkahtalledh	tjalh^kah^tal^ledh
tjallegåetedh	tjal^le^gåe^tedh
tjallijahtjedh	tjal^li^jah^tjedh
tjalmahtoevedh	tjal^mah^toe^vedh
tjalmahtovvedh	tjal^mah^tov^vedh
tjalmehtoevedh	tjal^meh^toe^vedh
tjalmehtovvedh	tjal^meh^tov^vedh
tjanghkalgovvedh	tjangh^kal^gov^vedh
tjanghkestehtedh	tjangh^kes^teh^tedh
tjarhtestalledh	tjarh^tes^tal^ledh
tjarmedadtedh	tjar^me^dad^tedh
tjarmehtalledh	tjar^meh^tal^ledh
tjarmestalledh	tjar^mes^tal^ledh
tjatneloevedh	tjat^ne^loe^vedh
tjatnelostedh	tjat^ne^los^tedh
tjatnestehtedh	tjat^nes^teh^tedh
tjavlastalledh	tjav^las^tal^ledh
tjavtjestalledh	tjav^tjes^tal^ledh
tjeahkehtehtedh	tjeah^keh^teh^tedh
tjeahpastalledh	tjeah^pas^tal^ledh
tjearadehtedh	tjea^ra^deh^tedh
tjearahtehtedh	tjea^rah^teh^tedh
tjearoehtehtedh	tjea^roeh^teh^tedh
tjearvadehtedh	tjear^va^deh^tedh
tjearvarostedh	tjear^va^ros^tedh
tjeavladalledh	tjeav^la^dal^ledh
tjelmiehtovvedh	tjel^mieh^tov^vedh
tjietsiestehtedh	tjie^tsies^teh^tedh
tjihkenestedh	tjih^ke^nes^tedh
tjihkesadtedh	tjih^ke^sad^tedh
tjihkesalledh	tjih^ke^sal^ledh
tjirrelgåetedh	tjir^rel^gåe^tedh
tjoehpedistedh	tjoeh^pe^dis^tedh
tjoehpegåetedh	tjoeh^pe^gåe^tedh
tjoehpehtalledh	tjoeh^peh^tal^ledh
tjoejkegåetedh	tjoej^ke^gåe^tedh
tjoejkehtalledh	tjoej^keh^tal^ledh
tjoejkehtehtedh	tjoej^keh^teh^tedh
tjoemehtehtedh	tjoe^meh^teh^tedh
tjoetsehtjadtedh	tjoe^tseh^tjad^tedh
tjogkeldehtedh	tjog^kel^deh^tedh
tjohkehtehtedh	tjoh^keh^teh^tedh
tjohkehtovvedh	tjoh^keh^tov^vedh
tjolhterostedh	tjolh^te^ros^tedh
tjolkemehtedh	tjol^ke^meh^tedh
tjolmestalledh	tjol^mes^tal^ledh
tjuadtjaladtedh	tjuad^tja^lad^tedh
tjuakastovvedh	tjua^kas^tov^vedh
tjuedtjielestedh	tjued^tjie^les^tedh
tjuntjestalledh	tjun^tjes^tal^ledh
tjyskehtalledh	tjys^keh^tal^ledh
tjyörestalledh	tjyö^res^tal^ledh
tjyöriejehtedh	tjyö^rie^jeh^tedh
tjyörijehtedh	tjyö^ri^jeh^tedh
tjyöskehtalledh	tjyös^keh^tal^ledh
tjåadtjahtehtedh	tjåad^tjah^teh^tedh
tjåadtjaladtedh	tjåad^tja^lad^tedh
tjåadtjoehtehtedh	tjåad^tjoeh^teh^tedh
tjåagkehtjadtedh	tjåag^keh^tjad^tedh
tjåanahtehtedh	tjåa^nah^teh^tedh
tjåanghkanadtedh	tjåangh^ka^nad^tedh
tjåanghkenadtedh	tjåangh^ke^nad^tedh
tjåenghkierdistedh	tjåengh^kier^dis^tedh
tjåhkahtalledh	tjåh^kah^tal^ledh
tjålhkajdalledh	tjålh^kaj^dal^ledh
tjångkalgovvedh	tjång^kal^gov^vedh
tjåvlastalledh	tjåv^las^tal^ledh
tjåvraradtedh	tjåv^ra^rad^tedh
tjåvvalgovvedh	tjåv^val^gov^vedh
tjåådtjedadtedh	tjååd^tje^dad^tedh
tjååhpedehtedh	tjååh^pe^deh^tedh
tjååhpedestedh	tjååh^pe^des^tedh
tjåålhkesehtedh	tjåålh^ke^seh^tedh
tjåånehtehtedh	tjåå^neh^teh^tedh
tjåårestalledh	tjåå^res^tal^ledh
tjååriejehtedh	tjåå^rie^jeh^tedh
tjåårijehtedh	tjåå^ri^jeh^tedh
tjåårresadtedh	tjåår^re^sad^tedh
tjïekedadtedh	tjïe^ke^dad^tedh
tjïelkestehtedh	tjïel^kes^teh^tedh
tjïktjestalledh	tjïk^tjes^tal^ledh
tjïrrehtovvedh	tjïr^reh^tov^vedh
tjïrrelgoevedh	tjïr^rel^goe^vedh
tjïrrelgovvedh	tjïr^rel^gov^vedh
tjïrrelgåetedh	tjïr^rel^gåe^tedh
tjöödtjehtehtedh	tjööd^tjeh^teh^tedh
tjöönghkedistedh	tjööngh^ke^dis^tedh
tjöönghkegåetedh	tjööngh^ke^gåe^tedh
tjöönghkesovvedh	tjööngh^ke^sov^vedh
tjöörestalledh	tjöö^res^tal^ledh
tolereeredh	to^le^ree^redh
torpedeeredh	tor^pe^dee^redh
tortureeredh	tor^tu^ree^redh
tousjeeredh	to^u^sjee^redh
tousjeeredh	to^u^sjee^redh
traagkadalledh	traag^ka^dal^ledh
trabeleeredh	tra^be^lee^redh
trafikeeredh	tra^fi^kee^redh
trafikkeeredh	tra^fik^kee^redh
trakasseeredh	tra^kas^see^redh
tramstarostedh	tram^sta^ros^tedh
transendeeredh	tran^sen^dee^redh
transendeeredh	tran^sen^dee^redh
transfereeredh	tran^sfe^ree^redh
transfundeeredh	tran^sfun^dee^redh
transiteeredh	tran^si^tee^redh
transitteeredh	tran^sit^tee^redh
transkribeeredh	trans^kri^bee^redh
transmitteeredh	tran^smit^tee^redh
transpireeredh	tran^spi^ree^redh
transplanteeredh	transp^lan^tee^redh
transponeeredh	tran^spo^nee^redh
transporteeredh	tran^spor^tee^redh
transskribeeredh	transs^kri^bee^redh
traverseeredh	tra^ver^see^redh
travesteeredh	tra^ves^tee^redh
treegkesovvedh	treeg^ke^sov^vedh
tremuleeredh	tre^mu^lee^redh
triumfeeredh	tri^um^fee^redh
tromhpestehtedh	tromh^pes^teh^tedh
tromhpestehtedh	tromh^pes^teh^tedh
trygkesovvedh	tryg^ke^sov^vedh
tråapkajdalledh	tråap^kaj^dal^ledh
tråågkesovvedh	trååg^ke^sov^vedh
trïengkestalledh	trïeng^kes^tal^ledh
trïesijahtjedh	trïe^si^jah^tjedh
trïjsedalledh	trïj^se^dal^ledh
tsaapedistedh	tsaa^pe^dis^tedh
tsabtsestehtedh	tsab^tses^teh^tedh
tsagkesalledh	tsag^ke^sal^ledh
tsamtsestehtedh	tsam^tses^teh^tedh
tsavtsastalledh	tsav^tsas^tal^ledh
tsavtsehtjadtedh	tsav^tseh^tjad^tedh
tsealhkastehtedh	tsealh^kas^teh^tedh
tsealhkastehtedh	tsealh^kas^teh^tedh
tseegkesovvedh	tseeg^ke^sov^vedh
tsihkestehtedh	tsih^kes^teh^tedh
tsoepkelovvedh	tsoep^ke^lov^vedh
tsoepkenadtedh	tsoep^ke^nad^tedh
tsovvehtjadtedh	tsov^veh^tjad^tedh
tsåakalostedh	tsåa^ka^los^tedh
tsåvtsehtjadtedh	tsåv^tseh^tjad^tedh
tsïehkijehtedh	tsïeh^ki^jeh^tedh
tsïhkestehtedh	tsïh^kes^teh^tedh
tsïhkijehtedh	tsïh^ki^jeh^tedh
tuvnehtalledh	tuv^neh^tal^ledh
typiseeredh	ty^pi^see^redh
tïngkestalledh	tïng^kes^tal^ledh
urhtsehtalledh	urht^seh^tal^ledh
urineeredh	u^ri^nee^redh
ussjedadtedh	us^sje^dad^tedh
ussjedalledh	us^sje^dal^ledh
ussjedistedh	us^sje^dis^tedh
usurpeeredh	u^sur^pee^redh
uvtelassedh	uv^te^las^sedh
vaadtsahtalledh	vaad^tsah^tal^ledh
vaadtsaldehtedh	vaad^tsal^deh^tedh
vaadtsehtjadtedh	vaad^tseh^tjad^tedh
vaajaldehtedh	vaa^jal^deh^tedh
vaajeldehtedh	vaa^jel^deh^tedh
vaajtelassjedh	vaaj^te^las^sjedh
vaajtelossjedh	vaaj^te^los^sjedh
vaajvesovvedh	vaaj^ve^sov^vedh
vaaljedehtedh	vaa^lje^deh^tedh
vaalmajdovvedh	vaal^maj^dov^vedh
vaaltaladtedh	vaal^ta^lad^tedh
vaaltasovvedh	vaal^ta^sov^vedh
vaanesoevedh	vaa^ne^soe^vedh
vaarrijahtjedh	vaar^ri^jah^tjedh
vaarrijïhtjedh	vaar^ri^jïh^tjedh
vaartjeskehtedh	vaar^tjes^keh^tedh
vadtehtjadtedh	vad^teh^tjad^tedh
vaedtsiehtehtedh	vaed^tsieh^teh^tedh
vaelmiedovvedh	vael^mie^dov^vedh
vajmeldehtedh	vaj^mel^deh^tedh
vajmestalledh	vaj^mes^tal^ledh
vaksineeredh	vak^si^nee^redh
valandeeredh	va^lan^dee^redh
valideeredh	va^li^dee^redh
valkesahtjedh	val^ke^sah^tjedh
valuteeredh	va^lu^tee^redh
valvegåetedh	val^ve^gåe^tedh
valvijahtjedh	val^vi^jah^tjedh
varhtoedehtedh	varh^toe^deh^tedh
varijeeredh	va^ri^jee^redh
varijeeredh	va^ri^jee^redh
veahkahtalledh	veah^kah^tal^ledh
veahkesadtedh	veah^ke^sad^tedh
veahkesalledh	veah^ke^sal^ledh
veaksastalledh	veak^sas^tal^ledh
veanadehtedh	vea^na^deh^tedh
veanadistedh	vea^na^dis^tedh
veartasovvedh	vear^ta^sov^vedh
vearteladtedh	vear^te^lad^tedh
vedtielestedh	ved^tie^les^tedh
veesmedehtedh	vees^me^deh^tedh
veevesovvedh	vee^ve^sov^vedh
vegeteeredh	ve^ge^tee^redh
ventileeredh	ven^ti^lee^redh
viegkeldehtedh	vieg^kel^deh^tedh
viehkiehtestedh	vieh^kieh^tes^tedh
viejiehtahtjedh	vie^jieh^tah^tjedh
vigileeredh	vi^gi^lee^redh
vihtenjestedh	vih^te^njes^tedh
vihtenjostedh	vih^te^njos^tedh
vijjedadtedh	vij^je^dad^tedh
vindiseeredh	vin^di^see^redh
vindiseeredh	vin^di^see^redh
visiteeredh	vi^si^tee^redh
viskesovvedh	vis^ke^sov^vedh
voehpestehtedh	voeh^pes^teh^tedh
voejedalledh	voe^je^dal^ledh
voejedehtedh	voe^je^deh^tedh
voejegåetedh	voe^je^gåe^tedh
voejehtehtedh	voe^jeh^teh^tedh
voejehtjadtedh	voe^jeh^tjad^tedh
voejnehtjadtedh	voej^neh^tjad^tedh
voejnesadtedh	voej^ne^sad^tedh
voeksedehtedh	voek^se^deh^tedh
voelehtjadtedh	voe^leh^tjad^tedh
voelestehtedh	voe^les^teh^tedh
voelkehtestedh	voel^keh^tes^tedh
voelkeldehtedh	voel^kel^deh^tedh
voelkestehtedh	voel^kes^teh^tedh
voelmestehtedh	voel^mes^teh^tedh
voelpesjadtedh	voel^pe^sjad^tedh
voengestehtedh	voe^nges^teh^tedh
voeptesmoevedh	voep^tes^moe^vedh
voeptesovvedh	voep^te^sov^vedh
voerestovvedh	voe^res^tov^vedh
voerkesovvedh	voer^ke^sov^vedh
voerpesmehtedh	voer^pes^meh^tedh
voerpesoevedh	voer^pe^soe^vedh
voerpesovvedh	voer^pe^sov^vedh
voetjeladtedh	voe^tje^lad^tedh
voevjehtjadtedh	voev^jeh^tjad^tedh
voevnehtovvedh	voev^neh^tov^vedh
voevtsestehtedh	voev^tses^teh^tedh
voltigeeredh	vol^ti^gee^redh
vorpesmehtedh	vor^pes^meh^tedh
vuajahtalledh	vua^jah^tal^ledh
vuanoestehtedh	vua^noes^teh^tedh
vuapsasovvedh	vuap^sa^sov^vedh
vuaptastehtedh	vuap^tas^teh^tedh
vuartahtalledh	vuar^tah^tal^ledh
vuartasjadtedh	vuar^ta^sjad^tedh
vuartastalledh	vuar^tas^tal^ledh
vuasahtalledh	vua^sah^tal^ledh
vuastalestedh	vuas^ta^les^tedh
vuatjasovvedh	vua^tja^sov^vedh
vueliedistedh	vue^lie^dis^tedh
vuelkiehtehtedh	vuel^kieh^teh^tedh
vuertiehtehtedh	vuer^tieh^teh^tedh
vyjhpedehtedh	vyjh^pe^deh^tedh
vyjhpelostedh	vyjh^pe^los^tedh
vyjhpesehtedh	vyjh^pe^seh^tedh
vyjhpestehtedh	vyjh^pes^teh^tedh
vyskedehtedh	vys^ke^deh^tedh
vyöhkesjadtedh	vyöh^ke^sjad^tedh
vyöjhkesadtedh	vyöjh^ke^sad^tedh
vyölkedehtedh	vyöl^ke^deh^tedh
vyönehtalledh	vyö^neh^tal^ledh
våajadehtedh	våa^ja^deh^tedh
våajoedehtedh	våa^joe^deh^tedh
våajoejahtjedh	våa^joe^jah^tjedh
våarastalledh	våa^ras^tal^ledh
våarastovvedh	våa^ras^tov^vedh
våaroestalledh	våa^roes^tal^ledh
våatjastehtedh	våa^tjas^teh^tedh
vååjeldehtedh	våå^jel^deh^tedh
vååjelgovvedh	våå^jel^gov^vedh
vååjnegåetedh	vååj^ne^gåe^tedh
væjkaladtedh	væj^ka^lad^tedh
væjsastalledh	væj^sas^tal^ledh
værhtoedehtedh	værh^toe^deh^tedh
væssjastehtedh	væs^sjas^teh^tedh
væssjoedehtedh	væs^sjoe^deh^tedh
vïegkeldehtedh	vïeg^kel^deh^tedh
vïehkesadtedh	vïeh^ke^sad^tedh
vïehkesjadtedh	vïeh^ke^sjad^tedh
vïekesjadtedh	vïe^ke^sjad^tedh
vïerhvesjovvedh	vïerh^ve^sjov^vedh
vïerteladtedh	vïer^te^lad^tedh
vïesehtahtjedh	vïe^seh^tah^tjedh
vïevtjedalledh	vïev^tje^dal^ledh
vïevtjerostedh	vïev^tje^ros^tedh
vïhtesjadtedh	vïh^te^sjad^tedh
vïjjedadtedh	vïj^je^dad^tedh
vïjkesjadtedh	vïj^ke^sjad^tedh
vïjlehtalledh	vïj^leh^tal^ledh
vïjvestehtedh	vïj^ves^teh^tedh
vïngkelostedh	vïng^ke^los^tedh
vïssjehtehtedh	vïs^sjeh^teh^tedh
vïssjehtoevedh	vïs^sjeh^toe^vedh
vïssjehtovvedh	vïs^sjeh^tov^vedh
vïtnedalledh	vït^ne^dal^ledh
vïtnehtalledh	vït^neh^tal^ledh
vïtnehtestedh	vït^neh^tes^tedh
vïtnelostedh	vït^ne^los^tedh
vïtnerostedh	vït^ne^ros^tedh
vïtnjelovvedh	vït^nje^lov^vedh
vöörhkesovvedh	vöörh^ke^sov^vedh
yörhkedehtedh	yörh^ke^deh^tedh
åadajadtedh	åa^da^jad^tedh
åadehtjadtedh	åa^deh^tjad^tedh
åadtjajdovvedh	åad^tjaj^dov^vedh
åadtjestalledh	åad^tjes^tal^ledh
åahpanadtedh	åah^pa^nad^tedh
åahpenadtedh	åah^pe^nad^tedh
åajaldehtedh	åa^jal^deh^tedh
åajaldovvedh	åa^jal^dov^vedh
åajalgoevedh	åa^jal^goe^vedh
åajalostedh	åa^ja^los^tedh
åajeldehtedh	åa^jel^deh^tedh
åajkaskehtedh	åaj^kas^keh^tedh
åajkaskoevedh	åaj^kas^koe^vedh
åajvadalledh	åaj^va^dal^ledh
åajvahtehtedh	åaj^vah^teh^tedh
åalhtaradtedh	åalh^ta^rad^tedh
åamaskoevedh	åa^mas^koe^vedh
åamastoevedh	åa^mas^toe^vedh
åanadalledh	åa^na^dal^ledh
åanamdalledh	åa^nam^dal^ledh
åarajadtedh	åa^ra^jad^tedh
åarajehtedh	åa^ra^jeh^tedh
åarajistedh	åa^ra^jis^tedh
åarehtjadtedh	åa^reh^tjad^tedh
åavrastehtedh	åav^ras^teh^tedh
åavrastovvedh	åav^ras^tov^vedh
åehpiedehtedh	åeh^pie^deh^tedh
åeniedehtedh	åe^nie^deh^tedh
åeniemdehtedh	åe^niem^deh^tedh
åevriedahtjedh	åev^rie^dah^tjedh
åjkardalledh	åj^kar^dal^ledh
ållermaehtedh	ål^ler^maeh^tedh
ålmastalledh	ål^mas^tal^ledh
ålvehtehtedh	ål^veh^teh^tedh
ålvehtovvedh	ål^veh^tov^vedh
ålvesadtedh	ål^ve^sad^tedh
åtnahtalledh	åt^nah^tal^ledh
åtnalgovvedh	åt^nal^gov^vedh
åtnalovvedh	åt^na^lov^vedh
åtnasovvedh	åt^na^sov^vedh
åådtjedistedh	ååd^tje^dis^tedh
ååjmehtovvedh	ååj^meh^tov^vedh
ååjsehtalledh	ååj^seh^tal^ledh
åålmehtehtedh	åål^meh^teh^tedh
ååntjestalledh	åån^tjes^tal^ledh
ååvnehtalledh	ååv^neh^tal^ledh
ællasovvedh	æl^la^sov^vedh
ærmoedehtedh	ær^moe^deh^tedh
ïedtjeldehtedh	ïed^tjel^deh^tedh
ïejmestalledh	ïej^mes^tal^ledh
ïepkergehtedh	ïep^ker^geh^tedh
ïepkergovvedh	ïep^ker^gov^vedh
ööhpehtalledh	ööh^peh^tal^ledh
öörnedehtedh	öör^ne^deh^tedh
öörnesovvedh	öör^ne^sov^vedh
