aabparidh	aab^pa^ridh
aabpastidh	aab^pas^tidh
aabpesidh	aab^pe^sidh
aagkesjidh	aag^ke^sjidh
aahpeldidh	aah^pel^didh
aahtjestidh	aah^tjes^tidh
aajanidh	aa^ja^nidh
aajkelidh	aaj^ke^lidh
aajmoehtidh	aaj^moeh^tidh
aajngehtidh	aaj^ngeh^tidh
aajngesjidh	aaj^nge^sjidh
aajpanidh	aaj^pa^nidh
aajpenidh	aaj^pe^nidh
aajsanidh	aaj^sa^nidh
aajsenidh	aaj^se^nidh
aajveldidh	aaj^vel^didh
aajverdidh	aaj^ver^didh
aajvestidh	aaj^ves^tidh
aalesjidh	aa^le^sjidh
aalhtedidh	aalh^te^didh
aalhtelidh	aalh^te^lidh
aalmoestidh	aal^moes^tidh
aaloestidh	aa^loes^tidh
aalpesidh	aal^pe^sidh
aamhtestidh	aamh^tes^tidh
aangkerdidh	aang^ker^didh
aanoehtidh	aa^noeh^tidh
aanoestidh	aa^noes^tidh
aaparidh	aa^pa^ridh
aarjoehtidh	aar^joeh^tidh
aarkadidh	aar^ka^didh
aarmaridh	aar^ma^ridh
aarmoedidh	aar^moe^didh
aarnesjidh	aar^ne^sjidh
aarvesidh	aar^ve^sidh
aaseldidh	aa^sel^didh
aassjoestidh	aas^sjoes^tidh
aatskadidh	aats^ka^didh
aavesidh	aa^ve^sidh
aavestidh	aa^ves^tidh
aavhrenidh	aavh^re^nidh
aavhtestidh	aavh^tes^tidh
aavoedidh	aa^voe^didh
aavtaridh	aav^ta^ridh
abpesidh	ab^pe^sidh
abrastidh	ab^ras^tidh
aebliehtidh	aeb^lieh^tidh
aejhtiestidh	aejh^ties^tidh
aejkiedidh	aej^kie^didh
aejkiestidh	aej^kies^tidh
aejliestidh	aej^lies^tidh
aejvierdidh	aej^vier^didh
aejviestidh	aej^vies^tidh
aelkiehtidh	ael^kieh^tidh
aelkiestidh	ael^kies^tidh
aelmiedidh	ael^mie^didh
aelpiedidh	ael^pie^didh
aeltiestidh	ael^ties^tidh
aerviedidh	aer^vie^didh
aeskiehtidh	aes^kieh^tidh
aeskielidh	aes^kie^lidh
aesmieldidh	aes^miel^didh
aevtiemdidh	aev^tiem^didh
ahtjamidh	ah^tja^midh
ahtjanidh	ah^tja^nidh
ahtjasjidh	ah^tja^sjidh
ajpedidh	aj^pe^didh
ajpestidh	aj^pes^tidh
ajtoedidh	aj^toe^didh
aktanidh	ak^ta^nidh
alkestidh	al^kes^tidh
allasidh	al^la^sidh
alvesidh	al^ve^sidh
ammestidh	am^mes^tidh
arhkanidh	arh^ka^nidh
arhkanidh	arh^ka^nidh
arhkanidh	arh^ka^nidh
arhkanidh	arh^ka^nidh
arhkanidh	arh^ka^nidh
arhkanidh	arh^ka^nidh
arhkelidh	arh^ke^lidh
armoedidh	ar^moe^didh
asvedidh	as^ve^didh
atjmoedidh	atj^moe^didh
atnahtidh	at^nah^tidh
atnelidh	at^ne^lidh
baadtedidh	baad^te^didh
baadtehtidh	baad^teh^tidh
baagkoehtidh	baag^koeh^tidh
baahkedidh	baah^ke^didh
baahkemdidh	baah^kem^didh
baahkenidh	baah^ke^nidh
baahkenidh	baah^ke^nidh
baahkestidh	baah^kes^tidh
baahtsehtidh	baah^tseh^tidh
baahtsehtidh	baah^tseh^tidh
baajedidh	baa^je^didh
baajhtestidh	baajh^tes^tidh
baajhtoelidh	baajh^toe^lidh
baajkelidh	baaj^ke^lidh
baajkoehtidh	baaj^koeh^tidh
baajpalidh	baaj^pa^lidh
baakoedidh	baa^koe^didh
baalkerdidh	baal^ker^didh
baaltedidh	baal^te^didh
baantjegidh	baan^tje^gidh
baantjeldidh	baan^tjel^didh
baapkehtidh	baap^keh^tidh
baartehtidh	baar^teh^tidh
baartestidh	baar^tes^tidh
baarvesjidh	baar^ve^sjidh
baataridh	baa^ta^ridh
baateridh	baa^te^ridh
baatjasidh	baa^tja^sidh
baatsedidh	baa^tse^didh
baaveldidh	baa^vel^didh
baaverdidh	baa^ver^didh
baaveridh	baa^ve^ridh
baavesidh	baa^ve^sidh
baavhkestidh	baavh^kes^tidh
baavresidh	baav^re^sidh
baavresjidh	baav^re^sjidh
badtehtidh	bad^teh^tidh
badtjadidh	bad^tja^didh
badtjaridh	bad^tja^ridh
baegkiehtidh	baeg^kieh^tidh
baehkiedidh	baeh^kie^didh
baehkierdidh	baeh^kier^didh
baejhtielidh	baejh^tie^lidh
baejkiestidh	baej^kies^tidh
baejskiehtidh	baej^skieh^tidh
baektjiedidh	baek^tjie^didh
baektjieridh	baek^tjie^ridh
baelhkiestidh	baelh^kies^tidh
baeljiestidh	bae^ljies^tidh
baepkiestidh	baep^kies^tidh
baeriemdidh	bae^riem^didh
baeriestidh	bae^ries^tidh
baerkieldidh	baer^kiel^didh
baersieldidh	baer^siel^didh
baertielidh	baer^tie^lidh
baetjiedidh	bae^tjie^didh
baetsielidh	bae^tsie^lidh
baetskiedidh	baets^kie^didh
baetskiedidh	baets^kie^didh
baetskiedidh	baets^kie^didh
baevtjiehtidh	baev^tjieh^tidh
bagkasjidh	bag^ka^sjidh
bagkedidh	bag^ke^didh
bagkegidh	bag^ke^gidh
bagkehtidh	bag^keh^tidh
bagkesidh	bag^ke^sidh
bahkasidh	bah^ka^sidh
bahtasidh	bah^ta^sidh
bahtsedidh	bah^tse^didh
bahtsegidh	bah^tse^gidh
bajhkoehtidh	bajh^koeh^tidh
bajjehtidh	baj^jeh^tidh
bajjesidh	baj^je^sidh
bajkasidh	baj^ka^sidh
baktjelidh	bak^tje^lidh
balhkardidh	balh^kar^didh
balledidh	bal^le^didh
ballehtidh	bal^leh^tidh
ballestidh	bal^les^tidh
baltastidh	bal^tas^tidh
balterdidh	bal^ter^didh
balvedidh	bal^ve^didh
banhkelidh	banh^ke^lidh
bansjelidh	ban^sje^lidh
bapkesidh	bap^ke^sidh
bapkestidh	bap^kes^tidh
barhkahtidh	barh^kah^tidh
barhkanidh	barh^ka^nidh
barhkelidh	barh^ke^lidh
barhkoehtidh	barh^koeh^tidh
barhvesjidh	barh^ve^sjidh
barjestidh	bar^jes^tidh
barkestidh	bar^kes^tidh
barranidh	bar^ra^nidh
barranidh	bar^ra^nidh
bartehtjidh	bar^teh^tjidh
bartelidh	bar^te^lidh
basjnegidh	basj^ne^gidh
baskedidh	bas^ke^didh
baskehtidh	bas^keh^tidh
baskelidh	bas^ke^lidh
baskeridh	bas^ke^ridh
baskestidh	bas^kes^tidh
bassastidh	bas^sas^tidh
bastesidh	bas^te^sidh
bastestidh	bas^tes^tidh
batnanidh	bat^na^nidh
batnenidh	bat^ne^nidh
bavhkehtidh	bavh^keh^tidh
bavvelidh	bav^ve^lidh
bavvestidh	bav^ves^tidh
beadtoelidh	bead^toe^lidh
beagkoehtidh	beag^koeh^tidh
beahkahtidh	beah^kah^tidh
beahkalidh	beah^ka^lidh
beajkadidh	beaj^ka^didh
beajstenidh	beaj^ste^nidh
beakerdidh	bea^ker^didh
bearadidh	bea^ra^didh
bearkadidh	bear^ka^didh
bearkanidh	bear^ka^nidh
beastelidh	beas^te^lidh
beavkastidh	beav^kas^tidh
bedtjiehtidh	bed^tjieh^tidh
bedtsiehtidh	bed^tsieh^tidh
bedtsielidh	bed^tsie^lidh
beekestidh	bee^kes^tidh
beeledidh	bee^le^didh
beelhkestidh	beelh^kes^tidh
beenghkestidh	beengh^kes^tidh
behtjiedidh	beh^tjie^didh
behtjiemdidh	beh^tjiem^didh
behtjiestidh	beh^tjies^tidh
behtsiedidh	beh^tsie^didh
bejhkiedidh	bejh^kie^didh
bejhkiehtidh	bejh^kieh^tidh
belkieldidh	bel^kiel^didh
beltielidh	bel^tie^lidh
benkiehtidh	ben^kieh^tidh
berkiestidh	ber^kies^tidh
betjkiestidh	betj^kies^tidh
betniehtidh	bet^nieh^tidh
biejverdidh	biej^ver^didh
bielhkielidh	bielh^kie^lidh
bielpierdidh	biel^pier^didh
biestielidh	bies^tie^lidh
bietskiedidh	biets^kie^didh
bietskiedidh	biets^kie^didh
bietskiedidh	biets^kie^didh
bietskiedidh	biets^kie^didh
bievnesjidh	biev^ne^sjidh
bihkiehtidh	bih^kieh^tidh
bihkiestidh	bih^kies^tidh
bihtsiedidh	bih^tsie^didh
bihtsiedidh	bih^tsie^didh
bijjiedidh	bij^jie^didh
bijjiedidh	bij^jie^didh
bijrielidh	bij^rie^lidh
biktiehtidh	bik^tieh^tidh
bilpehtidh	bil^peh^tidh
binhtsierdidh	binht^sier^didh
bintsiedidh	bin^tsie^didh
birhkehtidh	birh^keh^tidh
birrehtidh	bir^reh^tidh
birresjidh	bir^re^sjidh
birrestidh	bir^res^tidh
bismierdidh	bis^mier^didh
bissielidh	bis^sie^lidh
bissiestidh	bis^sies^tidh
bitkestidh	bit^kes^tidh
bitnehtidh	bit^neh^tidh
bitskestidh	bits^kes^tidh
bleeksjehtidh	bleek^sjeh^tidh
blutjkehtidh	blutj^keh^tidh
bobkestidh	bob^kes^tidh
bobpeldidh	bob^pel^didh
boejhkelidh	boejh^ke^lidh
boejhkesjidh	boejh^ke^sjidh
boejhkestidh	boejh^kes^tidh
boejsehtidh	boej^seh^tidh
boektelidh	boek^te^lidh
boektjestidh	boek^tjes^tidh
boektsestidh	boek^tses^tidh
boelehtjidh	boe^leh^tjidh
boelvedidh	boel^ve^didh
boelvestidh	boel^ves^tidh
boerestidh	boe^res^tidh
boerhkenidh	boerh^ke^nidh
boerkesjidh	boer^ke^sjidh
boerkestidh	boer^kes^tidh
boernedidh	boer^ne^didh
boerngelidh	boer^nge^lidh
boetkenidh	boet^ke^nidh
boetskestidh	boets^kes^tidh
bofferdidh	bof^fer^didh
bojhkelidh	bojh^ke^lidh
bollerdidh	bol^ler^didh
bolperdidh	bol^per^didh
bolterdidh	bol^ter^didh
bomhpegidh	bomh^pe^gidh
bonhkelidh	bonh^ke^lidh
bonhtegidh	bonh^te^gidh
bontjerdidh	bon^tjer^didh
bontseridh	bon^tse^ridh
bopkehtidh	bop^keh^tidh
bopkesidh	bop^ke^sidh
bopkestidh	bop^kes^tidh
bopmesjidh	bop^me^sjidh
borhkestidh	borh^kes^tidh
bormegidh	bor^me^gidh
borresidh	bor^re^sidh
borrestidh	bor^res^tidh
bosseldidh	bos^sel^didh
bovhtjehtidh	bovht^jeh^tidh
bovresjidh	bov^re^sjidh
bovvehtjidh	bov^veh^tjidh
bovvelidh	bov^ve^lidh
bovvestidh	bov^ves^tidh
brorrestidh	bror^res^tidh
bualajidh	bua^la^jidh
buaramidh	bua^ra^midh
buaranidh	bua^ra^nidh
buarasjidh	bua^ra^sjidh
buarastidh	bua^ras^tidh
buedkiestidh	bued^kies^tidh
buejhkiehtidh	buejh^kieh^tidh
buektelidh	buek^te^lidh
buektiehtidh	buek^tieh^tidh
buelielidh	bue^lie^lidh
bueriedidh	bue^rie^didh
bueriemdidh	bue^riem^didh
buerkiestidh	buer^kies^tidh
bueskiehtidh	bues^kieh^tidh
buhtjiedidh	buh^tjie^didh
buhtjiestidh	buh^tjies^tidh
bullierdidh	bul^lier^didh
bulpiehtidh	bul^pieh^tidh
bulpierdidh	bul^pier^didh
bunhkiehtidh	bunh^kieh^tidh
buntjierdidh	bun^tjier^didh
burhkiehtidh	burh^kieh^tidh
burrelidh	bur^re^lidh
bussestidh	bus^ses^tidh
buvnestidh	buv^nes^tidh
buvriedidh	buv^rie^didh
buvriehtidh	buv^rieh^tidh
buvrieldidh	buv^riel^didh
buvviestidh	buv^vies^tidh
byjhkesjidh	byjh^ke^sjidh
byjjenidh	byj^je^nidh
byrredidh	byr^re^didh
byrrehtidh	byr^reh^tidh
byöhkestidh	byöh^kes^tidh
byöjstenidh	byöj^ste^nidh
byöltendidh	byöl^ten^didh
byöltenidh	byöl^te^nidh
byöpmedidh	byöp^me^didh
byöpmedidh	byöp^me^didh
byörhkestidh	byörh^kes^tidh
byörkesjidh	byör^ke^sjidh
byötelidh	byö^te^lidh
båajhkoehtidh	båajh^koeh^tidh
båajsedidh	båaj^se^didh
båajtadidh	båaj^ta^didh
båajtaridh	båaj^ta^ridh
båajtoedidh	båaj^toe^didh
båakastidh	båa^kas^tidh
båakoestidh	båa^koes^tidh
båaktjestidh	båak^tjes^tidh
båalasidh	båa^la^sidh
båalmoehtidh	båal^moeh^tidh
båarastidh	båa^ras^tidh
båarkelidh	båar^ke^lidh
båarvoedidh	båar^voe^didh
båarvoelidh	båar^voe^lidh
båasaridh	båa^sa^ridh
båatelidh	båa^te^lidh
båatskestidh	båats^kes^tidh
bådtjadidh	båd^tja^didh
bådtjahtidh	båd^tjah^tidh
båehtjierdidh	båeh^tjier^didh
båelmiehtidh	båel^mieh^tidh
båeltielidh	båel^tie^lidh
båeltiestidh	båel^ties^tidh
båeriehtidh	båe^rieh^tidh
båerieldidh	båe^riel^didh
båerkiehtidh	båer^kieh^tidh
båerngiehtidh	båer^ngieh^tidh
båerviehtidh	båer^vieh^tidh
båetiejidh	båe^tie^jidh
båetieldidh	båe^tiel^didh
båetielidh	båe^tie^lidh
båetskiehtidh	båets^kieh^tidh
bågkedidh	båg^ke^didh
båhkaridh	båh^ka^ridh
båhtasidh	båh^ta^sidh
båhtjasidh	båh^tja^sidh
bålhkoehtidh	bålh^koeh^tidh
bållardidh	bål^lar^didh
båmhpasjidh	båmh^pa^sjidh
bånhkoehtidh	bånh^koeh^tidh
bånhtanidh	bånh^ta^nidh
båntjaridh	bån^tja^ridh
bårranidh	bår^ra^nidh
bårrelidh	bår^re^lidh
bårrestidh	bår^res^tidh
båsjlasjidh	båsj^la^sjidh
båssalidh	bås^sa^lidh
båssjalidh	bås^sja^lidh
båssoestidh	bås^soes^tidh
båtnanidh	båt^na^nidh
båvsajidh	båv^sa^jidh
båvsalidh	båv^sa^lidh
båvsegidh	båv^se^gidh
båvsehtidh	båv^seh^tidh
båvvasidh	båv^va^sidh
båvvastidh	båv^vas^tidh
bååhkesjidh	bååh^ke^sjidh
bååhperidh	bååh^pe^ridh
bååjmedidh	bååj^me^didh
båånesjidh	båå^ne^sjidh
båånhtserdidh	båånht^ser^didh
båånhtserdidh	båånht^ser^didh
båånhtseridh	båånht^se^ridh
båånhtseridh	båånht^se^ridh
bååremdidh	båå^rem^didh
bååresidh	båå^re^sidh
bååresjidh	båå^re^sjidh
båårestidh	båå^res^tidh
båårhkedidh	båårh^ke^didh
båårhkesjidh	båårh^ke^sjidh
bååveldidh	båå^vel^didh
bæhkasidh	bæh^ka^sidh
bæhtadidh	bæh^ta^didh
bæjhkoehtidh	bæjh^koeh^tidh
bæjhtadidh	bæjh^ta^didh
bæjjadidh	bæj^ja^didh
bæjjamidh	bæj^ja^midh
bæjjanidh	bæj^ja^nidh
bæjjoehtidh	bæj^joeh^tidh
bæjngoedidh	bæj^ngoe^didh
bæjrahtidh	bæj^rah^tidh
bæjroehtidh	bæj^roeh^tidh
bæjsamidh	bæj^sa^midh
bæktahtidh	bæk^tah^tidh
bïededidh	bïe^de^didh
bïegkelidh	bïeg^ke^lidh
bïegkestidh	bïeg^kes^tidh
bïehkestidh	bïeh^kes^tidh
bïehtedidh	bïeh^te^didh
bïehtsegidh	bïeh^tse^gidh
bïejkelidh	bïej^ke^lidh
bïejstegidh	bïej^ste^gidh
bïejstenidh	bïej^ste^nidh
bïekerdidh	bïe^ker^didh
bïelhkehtjidh	bïelh^keh^tjidh
bïeljelidh	bïe^lje^lidh
bïeljelidh	bïe^lje^lidh
bïeltemdidh	bïel^tem^didh
bïepmehtidh	bïep^meh^tidh
bïeredidh	bïe^re^didh
bïeredidh	bïe^re^didh
bïerjestidh	bïer^jes^tidh
bïerkelidh	bïer^ke^lidh
bïerkenidh	bïer^ke^nidh
bïeselidh	bïe^se^lidh
bïesmehtjidh	bïes^meh^tjidh
bïestelidh	bïes^te^lidh
bïevestidh	bïe^ves^tidh
bïevledidh	bïev^le^didh
bïevnjeldidh	bïev^njel^didh
bïgnesjidh	bïg^ne^sjidh
bïhkedidh	bïh^ke^didh
bïhkehtjidh	bïh^keh^tjidh
bïhkemdidh	bïh^kem^didh
bïhtjegidh	bïh^tje^gidh
bïhtsegidh	bïh^tse^gidh
bïjhkesjidh	bïjh^ke^sjidh
bïjveldidh	bïj^vel^didh
bïjvestidh	bïj^ves^tidh
bïjvijidh	bïj^vi^jidh
bïllijidh	bïl^li^jidh
bïlsedidh	bïl^se^didh
bïltedidh	bïl^te^didh
bïltelidh	bïl^te^lidh
bïrhtsehtidh	bïrht^seh^tidh
bïrrehtidh	bïr^reh^tidh
bïssedidh	bïs^se^didh
bööktjestidh	böök^tjes^tidh
böölelidh	böö^le^lidh
bööredidh	böö^re^didh
böörestidh	böö^res^tidh
böörhkestidh	böörh^kes^tidh
böötehtidh	böö^teh^tidh
böötskestidh	bööts^kes^tidh
böövtestidh	bööv^tes^tidh
daablestidh	daab^les^tidh
daabpamidh	daab^pa^midh
daabpanidh	daab^pa^nidh
daahterdidh	daah^ter^didh
daajedidh	daa^je^didh
daajesjidh	daa^je^sjidh
daajhtahtidh	daajh^tah^tidh
daajhtoehtidh	daajh^toeh^tidh
daajhvesjidh	daajh^ve^sjidh
daajkoedidh	daaj^koe^didh
daajrehtidh	daaj^reh^tidh
daajsehtidh	daaj^seh^tidh
daalhkestidh	daalh^kes^tidh
daamanidh	daa^ma^nidh
daamtjehtidh	daam^tjeh^tidh
daanhtsoehtidh	daanht^soeh^tidh
daanjehtidh	daa^njeh^tidh
daapadidh	daa^pa^didh
daaptjehtidh	daap^tjeh^tidh
daarastidh	daa^ras^tidh
daaresjidh	daa^re^sjidh
daarhvasjidh	daarh^va^sjidh
daaroestidh	daa^roes^tidh
daarpehtidh	daar^peh^tidh
daarpesjidh	daar^pe^sjidh
daastesjidh	daas^te^sjidh
daasvesjidh	daas^ve^sjidh
daavlesidh	daav^le^sidh
daavlesjidh	daav^le^sjidh
daavresjidh	daav^re^sjidh
dabpamidh	dab^pa^midh
dabpanidh	dab^pa^nidh
dabranidh	dab^ra^nidh
dabreldidh	dab^rel^didh
dabrelidh	dab^re^lidh
dabtijidh	dab^ti^jidh
daebliehtidh	daeb^lieh^tidh
daebpiedidh	daeb^pie^didh
daebpiedidh	daeb^pie^didh
daejmierdidh	daej^mier^didh
daejriehtidh	daej^rieh^tidh
daenghkierdidh	daengh^kier^didh
daepsjieldidh	daep^sjiel^didh
daevierdidh	dae^vier^didh
daeviestidh	dae^vies^tidh
dagnesidh	dag^ne^sidh
dagnestidh	dag^nes^tidh
dagrelidh	dag^re^lidh
dahkasjidh	dah^ka^sjidh
dahparidh	dah^pa^ridh
dahpesidh	dah^pe^sidh
dakngasjidh	dak^nga^sjidh
daltedidh	dal^te^didh
daltestidh	dal^tes^tidh
damhpahtidh	damh^pah^tidh
damtehtidh	dam^teh^tidh
damtesidh	dam^te^sidh
damtestidh	dam^tes^tidh
damtijidh	dam^ti^jidh
dangkahtidh	dang^kah^tidh
dapkehtidh	dap^keh^tidh
dapkerdidh	dap^ker^didh
dapkeridh	dap^ke^ridh
darhkelidh	darh^ke^lidh
darhkestidh	darh^kes^tidh
darhperdidh	darh^per^didh
darhpestidh	darh^pes^tidh
darhvestidh	darh^ves^tidh
darjoelidh	dar^joe^lidh
darrelidh	dar^re^lidh
darvenidh	dar^ve^nidh
darvesjidh	dar^ve^sjidh
dassedidh	das^se^didh
dasselidh	das^se^lidh
dassenidh	das^se^nidh
dassestidh	das^ses^tidh
davrelidh	dav^re^lidh
davtelidh	dav^te^lidh
davvoehtidh	dav^voeh^tidh
davvoelidh	dav^voe^lidh
deabpoedidh	deab^poe^didh
deadtelidh	dead^te^lidh
deadtesidh	dead^te^sidh
deahpadidh	deah^pa^didh
deajvaskidh	deaj^vas^kidh
deaktjadidh	deak^tja^didh
dealasidh	dea^la^sidh
dealaskidh	dea^las^kidh
dealkestidh	deal^kes^tidh
deallahtidh	deal^lah^tidh
deamalidh	dea^ma^lidh
deanahtidh	dea^nah^tidh
dearjesjidh	dear^je^sjidh
dearoedidh	dea^roe^didh
deaveridh	dea^ve^ridh
debriehtidh	deb^rieh^tidh
deegkehtidh	deeg^keh^tidh
deehkedidh	deeh^ke^didh
deehkehtidh	deeh^keh^tidh
deehtjehtidh	deeh^tjeh^tidh
deejehtidh	dee^jeh^tidh
deejhkehtidh	deejh^keh^tidh
deejhkehtidh	deejh^keh^tidh
deemedidh	dee^me^didh
deepmesjidh	deep^me^sjidh
deerehtidh	dee^reh^tidh
deervesjidh	deer^ve^sjidh
deetjkehtidh	deetj^keh^tidh
dehkiehtidh	deh^kieh^tidh
delhkiehtidh	delh^kieh^tidh
demhkiehtidh	demh^kieh^tidh
dibrehtidh	dib^reh^tidh
dibrelidh	dib^re^lidh
dibrestidh	dib^res^tidh
didtesjidh	did^te^sjidh
diedtielidh	died^tie^lidh
diejviedidh	diej^vie^didh
dielpierdidh	diel^pier^didh
diemsiestidh	diem^sies^tidh
diepmiedidh	diep^mie^didh
dierkesjidh	dier^ke^sjidh
dierkiestidh	dier^kies^tidh
dievhtiestidh	dievh^ties^tidh
dieviedidh	die^vie^didh
dievierdidh	die^vier^didh
dievieridh	die^vie^ridh
dievviedidh	diev^vie^didh
digkiedidh	dig^kie^didh
dihpierdidh	dih^pier^didh
dijniedidh	dij^nie^didh
dikngedidh	dik^nge^didh
dikngestidh	dik^nges^tidh
diktadidh	dik^ta^didh
diljegidh	di^lje^gidh
dilmierdidh	dil^mier^didh
dilmieridh	dil^mie^ridh
dimsiestidh	dim^sies^tidh
dipkehtidh	dip^keh^tidh
ditnesjidh	dit^ne^sjidh
doebpehtidh	doeb^peh^tidh
doebpelidh	doeb^pe^lidh
doehtedidh	doeh^te^didh
doekedidh	doe^ke^didh
doektjehtidh	doek^tjeh^tidh
doektjelidh	doek^tje^lidh
doelehtidh	doe^leh^tidh
doelhkestidh	doelh^kes^tidh
doeltehtidh	doel^teh^tidh
doeltijidh	doel^ti^jidh
doemenidh	doe^me^nidh
doemesjidh	doe^me^sjidh
doepehtidh	doe^peh^tidh
doepmesjidh	doep^me^sjidh
doeredidh	doe^re^didh
doerelidh	doe^re^lidh
doerkestidh	doer^kes^tidh
doesnestidh	does^nes^tidh
doevenidh	doe^ve^nidh
doffestidh	dof^fes^tidh
domhkelidh	domh^ke^lidh
domhkestidh	domh^kes^tidh
domhpenidh	domh^pe^nidh
domhpesjidh	domh^pe^sjidh
domsedidh	dom^se^didh
donestidh	do^nes^tidh
dongkehtidh	dong^keh^tidh
donhkelidh	donh^ke^lidh
donhkelidh	donh^ke^lidh
donhkestidh	donh^kes^tidh
donterdidh	don^ter^didh
dorhkeldidh	dorh^kel^didh
dorhkelidh	dorh^ke^lidh
dorjedidh	dor^je^didh
dorjehtidh	dor^jeh^tidh
dorkelidh	dor^ke^lidh
dormenidh	dor^me^nidh
dornestidh	dor^nes^tidh
dorsegidh	dor^se^gidh
doskelidh	dos^ke^lidh
dovhkerdidh	dovh^ker^didh
dovhtenidh	dovh^te^nidh
dovhtesjidh	dovh^te^sjidh
dovtelidh	dov^te^lidh
duasmaridh	duas^ma^ridh
duasvaridh	duas^va^ridh
dubpiedidh	dub^pie^didh
dubpiemdidh	dub^piem^didh
duebpiedidh	dueb^pie^didh
duebpiemdidh	dueb^piem^didh
dulhtjestidh	dulht^jes^tidh
dupkiehtidh	dup^kieh^tidh
durhkiehtidh	durh^kieh^tidh
duvsjedidh	duv^sje^didh
dygkedidh	dyg^ke^didh
dyvhtegidh	dyvh^te^gidh
dyölledidh	dyöl^le^didh
dyöredidh	dyö^re^didh
dåadtjelidh	dåad^tje^lidh
dåajvoehtidh	dåaj^voeh^tidh
dåaktjelidh	dåak^tje^lidh
dåalhkestidh	dåalh^kes^tidh
dåalmehtidh	dåal^meh^tidh
dåalvoehtidh	dåal^voeh^tidh
dåapahtidh	dåa^pah^tidh
dåarastidh	dåa^ras^tidh
dåarjadidh	dåar^ja^didh
dåarjedidh	dåar^je^didh
dåarjelidh	dåar^je^lidh
dåarjoehtidh	dåar^joeh^tidh
dåarmoehtidh	dåar^moeh^tidh
dåaroestidh	dåa^roes^tidh
dåasnastidh	dåas^nas^tidh
dåastoehtidh	dåas^toeh^tidh
dåbpanidh	dåb^pa^nidh
dåelviestidh	dåel^vies^tidh
dåemiedidh	dåe^mie^didh
dåepkiestidh	dåep^kies^tidh
dåepsiedidh	dåep^sie^didh
dåeriedidh	dåe^rie^didh
dåerieridh	dåe^rie^ridh
dåerkiestidh	dåer^kies^tidh
dåhkasjidh	dåh^ka^sjidh
dåmhpahtidh	dåmh^pah^tidh
dåssjanidh	dås^sja^nidh
dåvhkesidh	dåvh^ke^sidh
dåvhkesjidh	dåvh^ke^sjidh
dååjedidh	dåå^je^didh
dååjrehtidh	dååj^reh^tidh
dååkerdidh	dåå^ker^didh
dåålvedidh	dåål^ve^didh
dåånhtsedidh	dåånht^se^didh
dååpedidh	dåå^pe^didh
dååpestidh	dåå^pes^tidh
dåårejidh	dåå^re^jidh
dåårijidh	dåå^ri^jidh
dåårredidh	dåår^re^didh
dåårrehtidh	dåår^reh^tidh
dåårresidh	dåår^re^sidh
dååsveridh	dåås^ve^ridh
dååvhkesidh	dååvh^ke^sidh
dååvkestidh	dååv^kes^tidh
dængkoehtidh	dæng^koeh^tidh
dïdtesjidh	dïd^te^sjidh
dïeblesidh	dïeb^le^sidh
dïeblesjidh	dïeb^le^sjidh
dïeblestidh	dïeb^les^tidh
dïebpehtidh	dïeb^peh^tidh
dïebtjestidh	dïeb^tjes^tidh
dïedtelidh	dïed^te^lidh
dïedtesidh	dïed^te^sidh
dïedtjegidh	dïed^tje^gidh
dïejveldidh	dïej^vel^didh
dïektjegidh	dïek^tje^gidh
dïelhverdidh	dïelh^ver^didh
dïelkestidh	dïel^kes^tidh
dïelmesidh	dïel^me^sidh
dïelmestidh	dïel^mes^tidh
dïemtjestidh	dïem^tjes^tidh
dïemtsedidh	dïem^tse^didh
dïenehtidh	dïe^neh^tidh
dïenesjidh	dïe^ne^sjidh
dïeredidh	dïe^re^didh
dïerhkesjidh	dïerh^ke^sjidh
dïerhkestidh	dïerh^kes^tidh
dïerjesjidh	dïer^je^sjidh
dïervesjidh	dïer^ve^sjidh
dïeskerdidh	dïes^ker^didh
dïesvesjidh	dïes^ve^sjidh
dïetjkegidh	dïetj^ke^gidh
dïetjkehtidh	dïetj^keh^tidh
dïhperdidh	dïh^per^didh
dïjmedidh	dïj^me^didh
dïjmedidh	dïj^me^didh
dïjredidh	dïj^re^didh
dïjveldidh	dïj^vel^didh
dïmhperdidh	dïmh^per^didh
dïmperdidh	dïm^per^didh
dööhlestidh	dööh^les^tidh
döömelidh	döö^me^lidh
eabnadidh	eab^na^didh
eadtjoestidh	ead^tjoes^tidh
eadtoedidh	ead^toe^didh
eagnadidh	eag^na^didh
eajhkaldidh	eajh^kal^didh
eajhkalidh	eajh^ka^lidh
eaktjalidh	eak^tja^lidh
earadidh	ea^ra^didh
earjoehtidh	ear^joeh^tidh
earnadidh	ear^na^didh
earoehtidh	ea^roeh^tidh
easadidh	ea^sa^didh
eatjkaldidh	eatj^kal^didh
eatjkalidh	eatj^ka^lidh
eavadidh	ea^va^didh
eavedidh	ea^ve^didh
eebnestidh	eeb^nes^tidh
eejehtidh	ee^jeh^tidh
eejlestidh	eej^les^tidh
eejselidh	eej^se^lidh
eelpehtidh	eel^peh^tidh
ejjiedidh	ej^jie^didh
ejjiemdidh	ej^jiem^didh
ejtiedidh	ej^tie^didh
ejvieridh	ej^vie^ridh
ektiedidh	ek^tie^didh
ektienidh	ek^tie^nidh
elkiedidh	el^kie^didh
ennehtidh	en^neh^tidh
evtiedidh	ev^tie^didh
evtiemdidh	ev^tiem^didh
faagkadidh	faag^ka^didh
faahtjoestidh	faah^tjoes^tidh
faalehtidh	faa^leh^tidh
faalestidh	faa^les^tidh
faaradidh	faa^ra^didh
faarhmestidh	faarh^mes^tidh
faegniedidh	faeg^nie^didh
faehkiedidh	faeh^kie^didh
faektiehtidh	faek^tieh^tidh
faelhkiedidh	faelh^kie^didh
faepieldidh	fae^piel^didh
faerhkiedidh	faerh^kie^didh
faerhmiestidh	faerh^mies^tidh
fahkestidh	fah^kes^tidh
famhparidh	famh^pa^ridh
famparidh	fam^pa^ridh
fassehtidh	fas^seh^tidh
fasseldidh	fas^sel^didh
fatnehtidh	fat^neh^tidh
feahtaskidh	feah^tas^kidh
fealadidh	fea^la^didh
fearadidh	fea^ra^didh
fearhkedidh	fearh^ke^didh
fearhkelidh	fearh^ke^lidh
fearjadidh	fear^ja^didh
feaskadidh	feas^ka^didh
featagidh	fea^ta^gidh
feejjedidh	feej^je^didh
feeledidh	fee^le^didh
feerhkedidh	feerh^ke^didh
feerhmestidh	feerh^mes^tidh
feevrehtidh	feev^reh^tidh
fehkiehtidh	feh^kieh^tidh
ferriedidh	fer^rie^didh
fierhkiehtidh	fierh^kieh^tidh
fievsiedidh	fiev^sie^didh
fihkelidh	fih^ke^lidh
filhterdidh	filh^ter^didh
finkiehtidh	fin^kieh^tidh
firhkestidh	firh^kes^tidh
firrelidh	fir^re^lidh
firrestidh	fir^res^tidh
fissjerdidh	fis^sjer^didh
flavvaskidh	flav^vas^kidh
flåarastidh	flåa^ras^tidh
flæjjadidh	flæj^ja^didh
flïehkegidh	flïeh^ke^gidh
flïehkehtidh	flïeh^keh^tidh
flïjmerdidh	flïj^mer^didh
flöörestidh	flöö^res^tidh
foempeldidh	foem^pel^didh
foepedidh	foe^pe^didh
foeresjidh	foe^re^sjidh
fovresjidh	fov^re^sjidh
fraasadidh	fraa^sa^didh
freksiedidh	frek^sie^didh
frievniedidh	friev^nie^didh
frodkelidh	frod^ke^lidh
frorkelidh	fror^ke^lidh
frudkiehtidh	frud^kieh^tidh
frurkiehtidh	frur^kieh^tidh
frurkiehtidh	frur^kieh^tidh
fræskanidh	fræs^ka^nidh
fuakajidh	fua^ka^jidh
fuehkiehtidh	fueh^kieh^tidh
fuehpiedidh	fueh^pie^didh
fuejhkiehtidh	fuejh^kieh^tidh
fuekiehtidh	fue^kieh^tidh
fuhkiestidh	fuh^kies^tidh
fujhkesidh	fujh^ke^sidh
fulkesidh	ful^ke^sidh
funhterdidh	funh^ter^didh
funterdidh	fun^ter^didh
furpiedidh	fur^pie^didh
fyjlesjidh	fyj^le^sjidh
fyvdesjidh	fyv^de^sjidh
fyvresjidh	fyv^re^sjidh
fyödedidh	fyö^de^didh
fåarhtahtidh	fåarh^tah^tidh
fåårhmestidh	fåårh^mes^tidh
fååtesidh	fåå^te^sidh
fååtmestidh	fååt^mes^tidh
fæjladidh	fæj^la^didh
fæjloedidh	fæj^loe^didh
færhkestidh	færh^kes^tidh
færkasidh	fær^ka^sidh
fïedtenidh	fïed^te^nidh
fïekesjidh	fïe^ke^sjidh
fïelestidh	fïe^les^tidh
fïepeldidh	fïe^pel^didh
fïerhkelidh	fïerh^ke^lidh
fïeskesjidh	fïes^ke^sjidh
fïjhregidh	fïjh^re^gidh
fïjledidh	fïj^le^didh
fïjlesjidh	fïj^le^sjidh
fïjnehtidh	fïj^neh^tidh
fïjnestidh	fïj^nes^tidh
fïnkesidh	fïn^ke^sidh
fïrredidh	fïr^re^didh
fïrrelidh	fïr^re^lidh
fïvresjidh	fïv^re^sjidh
föörhkedidh	föörh^ke^didh
föörhkesjidh	föörh^ke^sjidh
gaagkestidh	gaag^kes^tidh
gaagnehtidh	gaag^neh^tidh
gaahkasjidh	gaah^ka^sjidh
gaahpanidh	gaah^pa^nidh
gaahpasjidh	gaah^pa^sjidh
gaahpegidh	gaah^pe^gidh
gaahtesidh	gaah^te^sidh
gaahtesjidh	gaah^te^sjidh
gaahtjedidh	gaah^tje^didh
gaajadidh	gaa^ja^didh
gaajedidh	gaa^je^didh
gaajesjidh	gaa^je^sjidh
gaajestidh	gaa^jes^tidh
gaajkerdidh	gaaj^ker^didh
gaajpanidh	gaaj^pa^nidh
gaajranidh	gaaj^ra^nidh
gaajrasjidh	gaaj^ra^sjidh
gaajtsoehtidh	gaaj^tsoeh^tidh
gaajvasjidh	gaaj^va^sjidh
gaajveldidh	gaaj^vel^didh
gaalehtjidh	gaa^leh^tjidh
gaalkahtidh	gaal^kah^tidh
gaalkanidh	gaal^ka^nidh
gaalkedidh	gaal^ke^didh
gaalkehtidh	gaal^keh^tidh
gaalkesidh	gaal^ke^sidh
gaalvedidh	gaal^ve^didh
gaamedidh	gaa^me^didh
gaamehtidh	gaa^meh^tidh
gaamhparidh	gaamh^pa^ridh
gaamhparidh	gaamh^pa^ridh
gaampestidh	gaam^pes^tidh
gaanedidh	gaa^ne^didh
gaanestidh	gaa^nes^tidh
gaantadidh	gaan^ta^didh
gaantestidh	gaan^tes^tidh
gaaredidh	gaa^re^didh
gaarehtidh	gaa^reh^tidh
gaarestidh	gaa^res^tidh
gaarhkedidh	gaarh^ke^didh
gaarhkelidh	gaarh^ke^lidh
gaarjanidh	gaar^ja^nidh
gaarkahtidh	gaar^kah^tidh
gaarkahtidh	gaar^kah^tidh
gaarkanidh	gaar^ka^nidh
gaarkasidh	gaar^ka^sidh
gaarkoehtidh	gaar^koeh^tidh
gaarkoehtidh	gaar^koeh^tidh
gaarmoedidh	gaar^moe^didh
gaarngoehtidh	gaar^ngoeh^tidh
gaarrasjidh	gaar^ra^sjidh
gaarregidh	gaar^re^gidh
gaarresjidh	gaar^re^sjidh
gaarsjelidh	gaar^sje^lidh
gaarvanidh	gaar^va^nidh
gaarvenidh	gaar^ve^nidh
gaarvestidh	gaar^ves^tidh
gaarvoehtidh	gaar^voeh^tidh
gaasedidh	gaa^se^didh
gaastadidh	gaas^ta^didh
gaastedidh	gaas^te^didh
gaasvaridh	gaas^va^ridh
gaatedidh	gaa^te^didh
gaatoelidh	gaa^toe^lidh
gaavestidh	gaa^ves^tidh
gaavhtaridh	gaavh^ta^ridh
gaavlesjidh	gaav^le^sjidh
gaavnedidh	gaav^ne^didh
gaavnehtidh	gaav^neh^tidh
gaavnesjidh	gaav^ne^sjidh
gaavnjegidh	gaav^nje^gidh
gaavnjerdidh	gaav^njer^didh
gabnjelidh	gab^nje^lidh
gabpeldidh	gab^pel^didh
gabregidh	gab^re^gidh
gabreldidh	gab^rel^didh
gabrestidh	gab^res^tidh
gabtanidh	gab^ta^nidh
gadkelidh	gad^ke^lidh
gadtaskidh	gad^tas^kidh
gadtastidh	gad^tas^tidh
gadtehtjidh	gad^teh^tjidh
gadtelidh	gad^te^lidh
gadtesidh	gad^te^sidh
gadtjedidh	gad^tje^didh
gadtjehtidh	gad^tjeh^tidh
gadtsedidh	gad^tse^didh
gadtsehtidh	gad^tseh^tidh
gadtsestidh	gad^tses^tidh
gaegkieridh	gaeg^kie^ridh
gaegkiestidh	gaeg^kies^tidh
gaegniedidh	gaeg^nie^didh
gaehpiedidh	gaeh^pie^didh
gaejsiedidh	gaej^sie^didh
gaejviehtidh	gaej^vieh^tidh
gaekierdidh	gae^kier^didh
gaektjiestidh	gaek^tjies^tidh
gaeliehtidh	gae^lieh^tidh
gaelvierdidh	gael^vier^didh
gaemhpierdidh	gaemh^pier^didh
gaemhpierdidh	gaemh^pier^didh
gaengkierdidh	gaeng^kier^didh
gaeriestidh	gae^ries^tidh
gaerkiehtidh	gaer^kieh^tidh
gaernjiehtidh	gaer^njieh^tidh
gaertjiedidh	gaer^tjie^didh
gaertjiedidh	gaer^tjie^didh
gaerviehtidh	gaer^vieh^tidh
gaesvierdidh	gaes^vier^didh
gaetskiestidh	gaets^kies^tidh
gaeviehtidh	gae^vieh^tidh
gaevnjierdidh	gaev^njier^didh
gahkamidh	gah^ka^midh
gahkanidh	gah^ka^nidh
gahkestidh	gah^kes^tidh
gahpestidh	gah^pes^tidh
gahtamidh	gah^ta^midh
gahtanidh	gah^ta^nidh
gahtjajidh	gah^tja^jidh
gahtjedidh	gah^tje^didh
gahtjehtidh	gah^tjeh^tidh
gahtjelidh	gah^tje^lidh
gahtsajidh	gah^tsa^jidh
gajhkanidh	gajh^ka^nidh
gajhkedidh	gajh^ke^didh
gajhkelidh	gajh^ke^lidh
gajhkesjidh	gajh^ke^sjidh
gajhkestidh	gajh^kes^tidh
gajhkoelidh	gajh^koe^lidh
gajhnasjidh	gajh^na^sjidh
gajhnegidh	gajh^ne^gidh
gajjalidh	gaj^ja^lidh
gajjaridh	gaj^ja^ridh
gajkahtidh	gaj^kah^tidh
gajkasjidh	gaj^ka^sjidh
gajvelidh	gaj^ve^lidh
gajvestidh	gaj^ves^tidh
gakngesjidh	gak^nge^sjidh
gakngestidh	gak^nges^tidh
gaksjahtidh	gak^sjah^tidh
galjanidh	ga^lja^nidh
galkelidh	gal^ke^lidh
gallanidh	gal^la^nidh
galmedidh	gal^me^didh
galtestidh	gal^tes^tidh
gamhkasjidh	gamh^ka^sjidh
gamhkesidh	gamh^ke^sidh
gamhkesjidh	gamh^ke^sjidh
gampeldidh	gam^pel^didh
gampelidh	gam^pe^lidh
gamtanidh	gam^ta^nidh
gapmanidh	gap^ma^nidh
gapmasjidh	gap^ma^sjidh
gaptjedidh	gap^tje^didh
gaptjelidh	gap^tje^lidh
gaptjestidh	gap^tjes^tidh
garhkasidh	garh^ka^sidh
garhkastidh	garh^kas^tidh
garhkestidh	garh^kes^tidh
garhkoedidh	garh^koe^didh
garhpestidh	garh^pes^tidh
garhpoedidh	garh^poe^didh
garhvoestidh	garh^voes^tidh
garkasidh	gar^ka^sidh
garkelidh	gar^ke^lidh
garkesidh	gar^ke^sidh
garkoehtidh	gar^koeh^tidh
garmaridh	gar^ma^ridh
garmeldidh	gar^mel^didh
garmerdidh	gar^mer^didh
garrahtidh	gar^rah^tidh
garrestidh	gar^res^tidh
garvehtjidh	gar^veh^tjidh
garvenidh	gar^ve^nidh
garvestidh	gar^ves^tidh
gaskestidh	gas^kes^tidh
gasnehtidh	gas^neh^tidh
gasngehtidh	gas^ngeh^tidh
gatskelidh	gats^ke^lidh
gatskesidh	gats^ke^sidh
gavlesjidh	gav^le^sjidh
gavsasjidh	gav^sa^sjidh
gavtjaridh	gav^tja^ridh
gavverdidh	gav^ver^didh
geadtjamidh	gead^tja^midh
geadtsanidh	gead^tsa^nidh
geagkaridh	geag^ka^ridh
geahkoedidh	geah^koe^didh
geahpamidh	geah^pa^midh
geahpanidh	geah^pa^nidh
geahpoedidh	geah^poe^didh
geahtjedidh	geah^tje^didh
geajhkardidh	geajh^kar^didh
geajhkaridh	geajh^ka^ridh
geajlasidh	geaj^la^sidh
geajpanidh	geaj^pa^nidh
geakasjidh	gea^ka^sjidh
geaktjamidh	geak^tja^midh
geaktjanidh	geak^tja^nidh
geaktsanidh	geak^tsa^nidh
gealadidh	gea^la^didh
gealkardidh	geal^kar^didh
geamhpasjidh	geamh^pa^sjidh
geanoehtidh	gea^noeh^tidh
gearvanidh	gear^va^nidh
geasadidh	gea^sa^didh
geasehtidh	gea^seh^tidh
geasehtjidh	gea^seh^tjidh
geatjastidh	gea^tjas^tidh
geatjedidh	gea^tje^didh
geatsedidh	gea^tse^didh
geatsestidh	gea^tses^tidh
geatskanidh	geats^ka^nidh
geavtamidh	geav^ta^midh
gebriehtidh	geb^rieh^tidh
gebriehtidh	geb^rieh^tidh
gebtiedidh	geb^tie^didh
gebtiedidh	geb^tie^didh
gedtielidh	ged^tie^lidh
gedtiestidh	ged^ties^tidh
gedtjieldidh	ged^tjiel^didh
geehpehtidh	geeh^peh^tidh
geehtedidh	geeh^te^didh
geehtestidh	geeh^tes^tidh
geelkestidh	geel^kes^tidh
geenestidh	gee^nes^tidh
geepestidh	gee^pes^tidh
geerehtidh	gee^reh^tidh
geerelidh	gee^re^lidh
geerestidh	gee^res^tidh
geerjehtidh	geer^jeh^tidh
geerkehtidh	geer^keh^tidh
geerredidh	geer^re^didh
geerrehtidh	geer^reh^tidh
geervehtidh	geer^veh^tidh
geesnjehtidh	gees^njeh^tidh
geevehtidh	gee^veh^tidh
geevestidh	gee^ves^tidh
gegkiestidh	geg^kies^tidh
gehtiedidh	geh^tie^didh
gehtiedidh	geh^tie^didh
gejhkiedidh	gejh^kie^didh
gejhkiehtidh	gejh^kieh^tidh
gejhkielidh	gejh^kie^lidh
gejhkiestidh	gejh^kies^tidh
gejvielidh	gej^vie^lidh
gelhkiehtidh	gelh^kieh^tidh
geljiedidh	ge^ljie^didh
geljiedidh	ge^ljie^didh
gelkiehtidh	gel^kieh^tidh
gelkierdidh	gel^kier^didh
gelmielidh	gel^mie^lidh
gelmielidh	gel^mie^lidh
geltiestidh	gel^ties^tidh
gemkiehtidh	gem^kieh^tidh
gemsjiedidh	gem^sjie^didh
gemsjiestidh	gem^sjies^tidh
gerriehtidh	ger^rieh^tidh
gesniestidh	ges^nies^tidh
gevsiedidh	gev^sie^didh
gevtjiehtidh	gev^tjieh^tidh
gevviehtidh	gev^vieh^tidh
gibrehtidh	gib^reh^tidh
gibrelidh	gib^re^lidh
giedtsiedidh	gied^tsie^didh
giedtsiedidh	gied^tsie^didh
giehpiedidh	gieh^pie^didh
giehpiedidh	gieh^pie^didh
giejhkiedidh	giejh^kie^didh
gieliedidh	gie^lie^didh
gieliestidh	gie^lies^tidh
gieriedidh	gie^rie^didh
gieriedidh	gie^rie^didh
giermiedidh	gier^mie^didh
gietskiedidh	giets^kie^didh
gietskiedidh	giets^kie^didh
gievledidh	giev^le^didh
gihtjedidh	gih^tje^didh
gihtjelidh	gih^tje^lidh
gihtjestidh	gih^tjes^tidh
gijhkierdidh	gijh^kier^didh
gijhnestidh	gijh^nes^tidh
gijmiestidh	gij^mies^tidh
gijvieldidh	gij^viel^didh
gikngieldidh	gik^ngiel^didh
gilkedidh	gil^ke^didh
gilledidh	gil^le^didh
gillehtidh	gil^leh^tidh
gillestidh	gil^les^tidh
gilmehtidh	gil^meh^tidh
gilvelidh	gil^ve^lidh
gimtiedidh	gim^tie^didh
gingsjehtidh	gings^jeh^tidh
girhkelidh	girh^ke^lidh
girvehtidh	gir^veh^tidh
gitskehtidh	gits^keh^tidh
goddijidh	god^di^jidh
goebperdidh	goeb^per^didh
goedtedidh	goed^te^didh
goedtehtjidh	goed^teh^tjidh
goedtelidh	goed^te^lidh
goegkedidh	goeg^ke^didh
goegkeldidh	goeg^kel^didh
goegkerdidh	goeg^ker^didh
goeglesjidh	goeg^le^sjidh
goeglestidh	goeg^les^tidh
goehpesjidh	goeh^pe^sjidh
goehpestidh	goeh^pes^tidh
goejesjidh	goe^je^sjidh
goejhkesjidh	goejh^ke^sjidh
goekestidh	goe^kes^tidh
goeksegidh	goek^se^gidh
goeljestidh	goe^ljes^tidh
goelkestidh	goel^kes^tidh
goelperdidh	goel^per^didh
goelperidh	goel^pe^ridh
goepedidh	goe^pe^didh
goeperdidh	goe^per^didh
goepkedidh	goep^ke^didh
goerehtidh	goe^reh^tidh
goerehtjidh	goe^reh^tjidh
goerhteldidh	goerh^tel^didh
goerkelidh	goer^ke^lidh
goerkesidh	goer^ke^sidh
goerpedidh	goer^pe^didh
goerpestidh	goer^pes^tidh
goesmeridh	goes^me^ridh
goesngehtidh	goes^ngeh^tidh
goestehtidh	goes^teh^tidh
goetsedidh	goe^tse^didh
goetsehtidh	goe^tseh^tidh
goetselidh	goe^tse^lidh
goetskehtidh	goets^keh^tidh
goetsmedidh	goets^me^didh
goetsmeridh	goets^me^ridh
goeveldidh	goe^vel^didh
goeverdidh	goe^ver^didh
goevlelidh	goev^le^lidh
goevlestidh	goev^les^tidh
goevlestidh	goev^les^tidh
gohtjedidh	goh^tje^didh
golhpesjidh	golh^pe^sjidh
goltelidh	gol^te^lidh
gompeldidh	gom^pel^didh
gomperdidh	gom^per^didh
gomtjeldidh	gom^tjel^didh
gorhkesjidh	gorh^ke^sjidh
gorhpehtidh	gorh^peh^tidh
gorkelidh	gor^ke^lidh
gorkesidh	gor^ke^sidh
gormesjidh	gor^me^sjidh
gorredidh	gor^re^didh
gorremdidh	gor^rem^didh
gorrijidh	gor^ri^jidh
gossestidh	gos^ses^tidh
gosteridh	gos^te^ridh
gotnesjidh	got^ne^sjidh
gotnjedidh	got^nje^didh
gotnjestidh	got^njes^tidh
govkedidh	gov^ke^didh
govlehtidh	gov^leh^tidh
govlestidh	gov^les^tidh
govlijidh	gov^li^jidh
govrestidh	gov^res^tidh
govtegidh	gov^te^gidh
guajhtsadidh	guajht^sa^didh
guaksadidh	guak^sa^didh
guaksagidh	guak^sa^gidh
guaktadidh	guak^ta^didh
guaktanidh	guak^ta^nidh
guanhtanidh	guanh^ta^nidh
guapasjidh	gua^pa^sjidh
guarjasjidh	guar^ja^sjidh
guarkadidh	guar^ka^didh
guassjalidh	guas^sja^lidh
gudtsiestidh	gud^tsies^tidh
guedtielidh	gued^tie^lidh
guedtiestidh	gued^ties^tidh
gueliestidh	gue^lies^tidh
gueljiestidh	gue^ljies^tidh
guelkiehtidh	guel^kieh^tidh
guenhtiehtidh	guenh^tieh^tidh
guepmierdidh	guep^mier^didh
guerkiehtidh	guer^kieh^tidh
guermiestidh	guer^mies^tidh
guhkiedidh	guh^kie^didh
guhkiedidh	guh^kie^didh
guhkiedidh	guh^kie^didh
guhkiehtidh	guh^kieh^tidh
guhtsiehtidh	guh^tsieh^tidh
gullehtidh	gul^leh^tidh
gupmiedidh	gup^mie^didh
gupmiehtidh	gup^mieh^tidh
gupmielidh	gup^mie^lidh
gupmierdidh	gup^mier^didh
gupmieridh	gup^mie^ridh
gupmiestidh	gup^mies^tidh
gurhkestidh	gurh^kes^tidh
gurhkiestidh	gurh^kies^tidh
gurkestidh	gur^kes^tidh
gurkiehtidh	gur^kieh^tidh
gurkiestidh	gur^kies^tidh
gurrieldidh	gur^riel^didh
gurviestidh	gur^vies^tidh
gusniedidh	gus^nie^didh
gutnedidh	gut^ne^didh
gutskiehtidh	guts^kieh^tidh
guvhkiehtidh	guvh^kieh^tidh
guvsiedidh	guv^sie^didh
guvviedidh	guv^vie^didh
gyhtsenidh	gyh^tse^nidh
gyhtsesidh	gyh^tse^sidh
gyjvedidh	gyj^ve^didh
gyjvesjidh	gyj^ve^sjidh
gyllerdidh	gyl^ler^didh
gynhtseridh	gynht^se^ridh
gyrhkesjidh	gyrh^ke^sjidh
gyrreldidh	gyr^rel^didh
gyskesjidh	gys^ke^sjidh
gyssedidh	gys^se^didh
gyvnjeldidh	gyv^njel^didh
gyvnjelidh	gyv^nje^lidh
gyvnjesidh	gyv^nje^sidh
gyvnjestidh	gyv^njes^tidh
gyvvenidh	gyv^ve^nidh
gyöhtjegidh	gyöh^tje^gidh
gyöllenidh	gyöl^le^nidh
györjesjidh	györ^je^sjidh
gåabragidh	gåab^ra^gidh
gåabregidh	gåab^re^gidh
gåadtjaridh	gåad^tja^ridh
gåadtsoedidh	gåad^tsoe^didh
gåahkehtidh	gåah^keh^tidh
gåajhkahtidh	gåajh^kah^tidh
gåajhkoehtidh	gåajh^koeh^tidh
gåajhtsadidh	gåajht^sa^didh
gåajhtsedidh	gåajht^se^didh
gåajparidh	gåaj^pa^ridh
gåajvoelidh	gåaj^voe^lidh
gåajvoestidh	gåaj^voes^tidh
gåaksastidh	gåak^sas^tidh
gåaljoestidh	gåa^ljoes^tidh
gåaloedidh	gåa^loe^didh
gåaloelidh	gåa^loe^lidh
gåaltadidh	gåal^ta^didh
gåaltastidh	gåal^tas^tidh
gåaltoedidh	gåal^toe^didh
gåaltoelidh	gåal^toe^lidh
gåaltoestidh	gåal^toes^tidh
gåamhpestidh	gåamh^pes^tidh
gåanghkasjidh	gåangh^ka^sjidh
gåankelidh	gåan^ke^lidh
gåaradidh	gåa^ra^didh
gåarahtidh	gåa^rah^tidh
gåaralidh	gåa^ra^lidh
gåarastidh	gåa^ras^tidh
gåarhmasjidh	gåarh^ma^sjidh
gåaroedidh	gåa^roe^didh
gåaroelidh	gåa^roe^lidh
gåaroestidh	gåa^roes^tidh
gåarpoestidh	gåar^poes^tidh
gåaskestidh	gåas^kes^tidh
gåassoehtidh	gåas^soeh^tidh
gåastaridh	gåas^ta^ridh
gåastoedidh	gåas^toe^didh
gåatoehtidh	gåa^toeh^tidh
gåavhregidh	gåavh^re^gidh
gåavrastidh	gåav^ras^tidh
gåavvahtidh	gåav^vah^tidh
gåestiedidh	gåes^tie^didh
gåhkadidh	gåh^ka^didh
gåhkalidh	gåh^ka^lidh
gåhkasjidh	gåh^ka^sjidh
gåhkoehtidh	gåh^koeh^tidh
gåhtsajidh	gåh^tsa^jidh
gåjhkelidh	gåjh^ke^lidh
gåjjahtidh	gåj^jah^tidh
gåjnaridh	gåj^na^ridh
gåksjoehtidh	gåk^sjoeh^tidh
gållagidh	gål^la^gidh
gålnjeridh	gål^nje^ridh
gåmhpadidh	gåmh^pa^didh
gåpmanidh	gåp^ma^nidh
gåpmasjidh	gåp^ma^sjidh
gåpmerdidh	gåp^mer^didh
gårkasidh	går^ka^sidh
gårkoehtidh	går^koeh^tidh
gårredidh	går^re^didh
gårrestidh	går^res^tidh
gåtjkoehtidh	gåtj^koeh^tidh
gåvhkesjidh	gåvh^ke^sjidh
gåvhkoehtidh	gåvh^koeh^tidh
gåvhtegidh	gåvh^te^gidh
gåvkasjidh	gåv^ka^sjidh
gåvlestidh	gåv^les^tidh
gåvnahtidh	gåv^nah^tidh
gåvnjerdidh	gåv^njer^didh
gåvnjoestidh	gåv^njoes^tidh
gåvnoehtidh	gåv^noeh^tidh
gåvtjaridh	gåv^tja^ridh
gåvverdidh	gåv^ver^didh
gååjhkedidh	gååjh^ke^didh
gååksedidh	gååk^se^didh
gååledidh	gåå^le^didh
gåålijidh	gåå^li^jidh
gååmhpedidh	gååmh^pe^didh
gååmhpestidh	gååmh^pes^tidh
gååredidh	gåå^re^didh
gåårkasidh	gåår^ka^sidh
gåårvedidh	gåår^ve^didh
gåårvehtidh	gåår^veh^tidh
gååtijidh	gåå^ti^jidh
gååvnesidh	gååv^ne^sidh
gæbpoedidh	gæb^poe^didh
gæhtjanidh	gæh^tja^nidh
gæhtjastidh	gæh^tjas^tidh
gæhtsanidh	gæh^tsa^nidh
gæhtsasjidh	gæh^tsa^sjidh
gæhtsoestidh	gæh^tsoes^tidh
gæjhkanidh	gæjh^ka^nidh
gæjhnasjidh	gæjh^na^sjidh
gæjhnegidh	gæjh^ne^gidh
gæjmastidh	gæj^mas^tidh
gæjmoedidh	gæj^moe^didh
gæjranidh	gæj^ra^nidh
gæjroedidh	gæj^roe^didh
gæktjastidh	gæk^tjas^tidh
gælhkasjidh	gælh^ka^sjidh
gæljadidh	gæ^lja^didh
gæljoehtidh	gæ^ljoeh^tidh
gællasjidh	gæl^la^sjidh
gælpoehtidh	gæl^poeh^tidh
gærrastidh	gær^ras^tidh
gærroedidh	gær^roe^didh
gærroestidh	gær^roes^tidh
gæssanidh	gæs^sa^nidh
gævnjahtidh	gæv^njah^tidh
gævnjasidh	gæv^nja^sidh
gævnjasjidh	gæv^nja^sjidh
gævnjastidh	gæv^njas^tidh
gævnjoestidh	gæv^njoes^tidh
gïeblestidh	gïeb^les^tidh
gïebredidh	gïeb^re^didh
gïebrenidh	gïeb^re^nidh
gïedesjidh	gïe^de^sjidh
gïehteldidh	gïeh^tel^didh
gïehtelidh	gïeh^te^lidh
gïehtjedidh	gïeh^tje^didh
gïehtjeldidh	gïeh^tjel^didh
gïehtjelidh	gïeh^tje^lidh
gïejkestidh	gïej^kes^tidh
gïekedidh	gïe^ke^didh
gïelkerdidh	gïel^ker^didh
gïemerdidh	gïe^mer^didh
gïemhpeldidh	gïemh^pel^didh
gïemtjeldidh	gïem^tjel^didh
gïenghkestidh	gïengh^kes^tidh
gïengsjehtidh	gïengs^jeh^tidh
gïepedidh	gïe^pe^didh
gïeresjidh	gïe^re^sjidh
gïerestidh	gïe^res^tidh
gïerkesjidh	gïer^ke^sjidh
gïeselidh	gïe^se^lidh
gïetedidh	gïe^te^didh
gïetsedidh	gïe^tse^didh
gïetsestidh	gïe^tses^tidh
gïevehtidh	gïe^veh^tidh
gïevredidh	gïev^re^didh
gïhpedidh	gïh^pe^didh
gïjkestidh	gïj^kes^tidh
gïjmedidh	gïj^me^didh
gïjredidh	gïj^re^didh
gïjregidh	gïj^re^gidh
gïjrestidh	gïj^res^tidh
gïjveldidh	gïj^vel^didh
gïkngestidh	gïk^nges^tidh
gïknjeldidh	gïk^njel^didh
gïknjelidh	gïk^nje^lidh
gïllerdidh	gïl^ler^didh
gïmpeldidh	gïm^pel^didh
gïrredidh	gïr^re^didh
gïrrelidh	gïr^re^lidh
gïrresidh	gïr^re^sidh
gïrtelidh	gïr^te^lidh
gïtnjeldidh	gït^njel^didh
gïvnjelidh	gïv^nje^lidh
gööledidh	göö^le^didh
göölestidh	göö^les^tidh
göörjedidh	göör^je^didh
göötestidh	göö^tes^tidh
göövestidh	göö^ves^tidh
göövledidh	gööv^le^didh
haabjelidh	haab^je^lidh
haabjesjidh	haab^je^sjidh
haadtoehtidh	haad^toeh^tidh
haagrestidh	haag^res^tidh
haahpeldidh	haah^pel^didh
haajpanidh	haaj^pa^nidh
haalanidh	haa^la^nidh
haalesjidh	haa^le^sjidh
haallasjidh	haal^la^sjidh
haalledidh	haal^le^didh
haaltasjidh	haal^ta^sjidh
haaltjasjidh	haal^tja^sjidh
haalvenidh	haal^ve^nidh
haamoedidh	haa^moe^didh
haampeldidh	haam^pel^didh
haampestidh	haam^pes^tidh
haanoehtidh	haa^noeh^tidh
haarjadidh	haar^ja^didh
haarjanidh	haar^ja^nidh
haarmedidh	haar^me^didh
haarmoedidh	haar^moe^didh
haasenidh	haa^se^nidh
haatjedidh	haa^tje^didh
haavhkestidh	haavh^kes^tidh
haavjanidh	haav^ja^nidh
haavjoelidh	haav^joe^lidh
haavjolidh	haav^jo^lidh
haavrestidh	haav^res^tidh
haavtaridh	haav^ta^ridh
hablesidh	hab^le^sidh
haebjiedidh	haeb^jie^didh
haejviehtidh	haej^vieh^tidh
haeliedidh	hae^lie^didh
haeliehtidh	hae^lieh^tidh
haelieridh	hae^lie^ridh
haeltjiehtidh	hael^tjieh^tidh
haemiedidh	hae^mie^didh
haeniedidh	hae^nie^didh
haeniehtidh	hae^nieh^tidh
haepiehtidh	hae^pieh^tidh
haepkiesjidh	haep^kie^sjidh
haertiedidh	haer^tie^didh
haetiedidh	hae^tie^didh
hahkadidh	hah^ka^didh
hahkanidh	hah^ka^nidh
hahkehtidh	hah^keh^tidh
hahkesjidh	hah^ke^sjidh
hahtadidh	hah^ta^didh
hajhkadidh	hajh^ka^didh
hajkedidh	haj^ke^didh
hajkehtidh	haj^keh^tidh
hajkelidh	haj^ke^lidh
hajkestidh	haj^kes^tidh
hakngehtidh	hak^ngeh^tidh
haktjahtidh	hak^tjah^tidh
haktjelidh	hak^tje^lidh
haktsahtidh	hak^tsah^tidh
halhkehtidh	halh^keh^tidh
halhkesidh	halh^ke^sidh
hamhkedidh	hamh^ke^didh
hamhkehtidh	hamh^keh^tidh
hamhkesidh	hamh^ke^sidh
hammoedidh	ham^moe^didh
hampelidh	ham^pe^lidh
hampestidh	ham^pes^tidh
hanhkedidh	hanh^ke^didh
hanhkehtidh	hanh^keh^tidh
hapkalidh	hap^ka^lidh
hapkelidh	hap^ke^lidh
hapkesidh	hap^ke^sidh
hapsajidh	hap^sa^jidh
harhkadidh	harh^ka^didh
hatjkahtidh	hatj^kah^tidh
hatskoehtidh	hats^koeh^tidh
havkehtidh	hav^keh^tidh
heajadidh	hea^ja^didh
heajanidh	hea^ja^nidh
heajhkaldidh	heajh^kal^didh
heajhkalidh	heajh^ka^lidh
heajjoedidh	heaj^joe^didh
heajkeldidh	heaj^kel^didh
heajnestidh	heaj^nes^tidh
healhkelidh	healh^ke^lidh
healladidh	heal^la^didh
healsadidh	heal^sa^didh
healsoehtidh	heal^soeh^tidh
heamesjidh	hea^me^sjidh
heannadidh	hean^na^didh
hearkoehtidh	hear^koeh^tidh
heavadidh	hea^va^didh
hebjiedidh	heb^jie^didh
heehkeldidh	heeh^kel^didh
heejnestidh	heej^nes^tidh
heekeldidh	hee^kel^didh
heeledidh	hee^le^didh
heepselidh	heep^se^lidh
heeptedidh	heep^te^didh
heerjehtidh	heer^jeh^tidh
heermestidh	heer^mes^tidh
heerredidh	heer^re^didh
heervenidh	heer^ve^nidh
heeselidh	hee^se^lidh
heevehtidh	hee^veh^tidh
heevestidh	hee^ves^tidh
hegliedidh	heg^lie^didh
hemhkiehtidh	hemh^kieh^tidh
hepkiehtidh	hep^kieh^tidh
hepsididh	hep^si^didh
hepsiedidh	hep^sie^didh
hepsiehtidh	hep^sieh^tidh
hertsiedidh	her^tsie^didh
hielhkiehtidh	hielh^kieh^tidh
hielhkiehtidh	hielh^kieh^tidh
hieriehtidh	hie^rieh^tidh
hihpelidh	hih^pe^lidh
hirrelidh	hir^re^lidh
hodtehtidh	hod^teh^tidh
hogkerdidh	hog^ker^didh
hohkenidh	hoh^ke^nidh
hohtjedidh	hoh^tje^didh
hojhkesidh	hojh^ke^sidh
hojhkesjidh	hojh^ke^sjidh
hojjedidh	hoj^je^didh
hojjestidh	hoj^jes^tidh
hojnegidh	hoj^ne^gidh
hoksehtidh	hok^seh^tidh
hoktjelidh	hok^tje^lidh
holkesidh	hol^ke^sidh
hollerdidh	hol^ler^didh
homhkesidh	homh^ke^sidh
hoskelidh	hos^ke^lidh
hoskesidh	hos^ke^sidh
hotskelidh	hots^ke^lidh
hovhkesidh	hovh^ke^sidh
hugkerdidh	hug^ker^didh
huhtiehtidh	huh^tieh^tidh
hujhkiehtidh	hujh^kieh^tidh
hulkesidh	hul^ke^sidh
humhkehtidh	humh^keh^tidh
humhkestidh	humh^kes^tidh
hummiestidh	hum^mies^tidh
hurpieldidh	hur^piel^didh
hursiedidh	hur^sie^didh
hurvelidh	hur^ve^lidh
hurvestidh	hur^ves^tidh
huvhnjiedidh	huvh^njie^didh
huvhnjiestidh	huvh^njies^tidh
huvviestidh	huv^vies^tidh
hyörhkedidh	hyörh^ke^didh
håajhkehtidh	håajh^keh^tidh
håajhkestidh	håajh^kes^tidh
håajpoestidh	håaj^poes^tidh
håallestidh	håal^les^tidh
håaloestidh	håa^loes^tidh
håarkestidh	håar^kes^tidh
håasenidh	håa^se^nidh
håavkegidh	håav^ke^gidh
håavkesjidh	håav^ke^sjidh
håejhkiehtidh	håejh^kieh^tidh
håevriedidh	håev^rie^didh
håhkesjidh	håh^ke^sjidh
håhtajidh	håh^ta^jidh
håjhkoestidh	håjh^koes^tidh
håjjedidh	håj^je^didh
håjnoedidh	håj^noe^didh
håjnoehtidh	håj^noeh^tidh
håjradidh	håj^ra^didh
håktselidh	håk^tse^lidh
håmpalidh	håm^pa^lidh
hårtsoehtidh	hår^tsoeh^tidh
håsvedidh	hås^ve^didh
håsveridh	hås^ve^ridh
håsvoeridh	hås^voe^ridh
håtskelidh	håts^ke^lidh
håtskoehtidh	håts^koeh^tidh
håvhnjasjidh	håvh^nja^sjidh
håvhtadidh	håvh^ta^didh
håågkedidh	hååg^ke^didh
hååjpestidh	hååj^pes^tidh
hååjpijidh	hååj^pi^jidh
hååkestidh	håå^kes^tidh
håålesjidh	håå^le^sjidh
håålestidh	håå^les^tidh
hååmestidh	håå^mes^tidh
håånedidh	håå^ne^didh
hååntjeldidh	håån^tjel^didh
hååntjelidh	håån^tje^lidh
hååntjelidh	håån^tje^lidh
hægkeldidh	hæg^kel^didh
hæhtadidh	hæh^ta^didh
hïehpenidh	hïeh^pe^nidh
hïejnestidh	hïej^nes^tidh
hïelhkelidh	hïelh^ke^lidh
hïerpehtidh	hïer^peh^tidh
hïerpendidh	hïer^pen^didh
hïerpenidh	hïer^pe^nidh
hïetelidh	hïe^te^lidh
hïevenidh	hïe^ve^nidh
hïrredidh	hïr^re^didh
hïsngestidh	hïs^nges^tidh
hïspehtidh	hïs^peh^tidh
hööllestidh	hööl^les^tidh
hööltestidh	hööl^tes^tidh
hööptestidh	hööp^tes^tidh
iepkieldidh	iep^kiel^didh
ieriedidh	ie^rie^didh
ierielidh	ie^rie^lidh
ierngiehtidh	ier^ngieh^tidh
iernjiehtidh	ier^njieh^tidh
iktedidh	ik^te^didh
ikteridh	ik^te^ridh
ilkedidh	il^ke^didh
illehtidh	il^leh^tidh
ipmierdidh	ip^mier^didh
irhkelidh	irh^ke^lidh
jaabnedidh	jaab^ne^didh
jaadtoestidh	jaad^toes^tidh
jaahkahtidh	jaah^kah^tidh
jaamedidh	jaa^me^didh
jaarkesjidh	jaar^ke^sjidh
jaavkeldidh	jaav^kel^didh
jaavoelidh	jaa^voe^lidh
jadtedidh	jad^te^didh
jadtehtidh	jad^teh^tidh
jaefiehtidh	jae^fieh^tidh
jaefiestidh	jae^fies^tidh
jaegniehtidh	jaeg^nieh^tidh
jaeltiehtidh	jael^tieh^tidh
jaemielidh	jae^mie^lidh
jaeptiehtidh	jaep^tieh^tidh
jaeptiestidh	jaep^ties^tidh
jaeviehtidh	jae^vieh^tidh
jaeviestidh	jae^vies^tidh
jagkaridh	jag^ka^ridh
jagkestidh	jag^kes^tidh
jahkadidh	jah^ka^didh
jahkoedidh	jah^koe^didh
jahtajidh	jah^ta^jidh
jahtehtjidh	jah^teh^tjidh
jakngedidh	jak^nge^didh
jaksahtidh	jak^sah^tidh
jakselidh	jak^se^lidh
jalhkasjidh	jalh^ka^sjidh
jalkedidh	jal^ke^didh
jalkelidh	jal^ke^lidh
jalkesjidh	jal^ke^sjidh
jalkesjidh	jal^ke^sjidh
jallamidh	jal^la^midh
jallanidh	jal^la^nidh
jalloedidh	jal^loe^didh
jamhkedidh	jamh^ke^didh
jamhkehtjidh	jamh^keh^tjidh
jamhkelidh	jamh^ke^lidh
jammaridh	jam^ma^ridh
jarhpoedidh	jarh^poe^didh
jarkastidh	jar^kas^tidh
jarkehtidh	jar^keh^tidh
jarkelidh	jar^ke^lidh
jarkesidh	jar^ke^sidh
jarkesjidh	jar^ke^sjidh
jarkestidh	jar^kes^tidh
jarkoestidh	jar^koes^tidh
jarrelidh	jar^re^lidh
jarrestidh	jar^res^tidh
jaskalidh	jas^ka^lidh
jaskehtidh	jas^keh^tidh
jaskelidh	jas^ke^lidh
jastasidh	jas^ta^sidh
jastelidh	jas^te^lidh
jatnasjidh	jat^na^sjidh
jatsvastidh	jats^vas^tidh
jeagkanidh	jeag^ka^nidh
jeahkoedidh	jeah^koe^didh
jeakadidh	jea^ka^didh
jealajidh	jea^la^jidh
jealaskidh	jea^las^kidh
jealehtjidh	jea^leh^tjidh
jeammaridh	jeam^ma^ridh
jeanamidh	jea^na^midh
jeananidh	jea^na^nidh
jeanasjidh	jea^na^sjidh
jearahtidh	jea^rah^tidh
jearoehtidh	jea^roeh^tidh
jeavahtidh	jea^vah^tidh
jebjiedidh	jeb^jie^didh
jebpiehtidh	jeb^pieh^tidh
jedtiehtidh	jed^tieh^tidh
jeegkehtidh	jeeg^keh^tidh
jeeredidh	jee^re^didh
jeevelidh	jee^ve^lidh
jegkieldidh	jeg^kiel^didh
jemhkiehtidh	jemh^kieh^tidh
jemhkieldidh	jemh^kiel^didh
jerhpiedidh	jerh^pie^didh
jerkiehtidh	jer^kieh^tidh
jerpiedidh	jer^pie^didh
jerpiedidh	jer^pie^didh
jestiehtidh	jes^tieh^tidh
jestielidh	jes^tie^lidh
jestiestidh	jes^ties^tidh
jevvieldidh	jev^viel^didh
jieliehtidh	jie^lieh^tidh
jieniedidh	jie^nie^didh
jieniemdidh	jie^niem^didh
jiepkieldidh	jiep^kiel^didh
jieriehtidh	jie^rieh^tidh
jievkehtidh	jiev^keh^tidh
jijhtiestidh	jijh^ties^tidh
jilhkedidh	jilh^ke^didh
jilliedidh	jil^lie^didh
jilliedidh	jil^lie^didh
jilliedidh	jil^lie^didh
jimhkelidh	jimh^ke^lidh
jimhkestidh	jimh^kes^tidh
jissiedidh	jis^sie^didh
jissiedidh	jis^sie^didh
jitnestidh	jit^nes^tidh
jobnesjidh	job^ne^sjidh
joejkedidh	joej^ke^didh
joejkestidh	joej^kes^tidh
joejkijidh	joej^ki^jidh
joejtehtidh	joej^teh^tidh
joekedidh	joe^ke^didh
joekehtidh	joe^keh^tidh
joevehtidh	joe^veh^tidh
joevenidh	joe^ve^nidh
jogrestidh	jog^res^tidh
johtehtjidh	joh^teh^tjidh
johtelidh	joh^te^lidh
joksedidh	jok^se^didh
jokseridh	jok^se^ridh
jolkesjidh	jol^ke^sjidh
jollerdidh	jol^ler^didh
joptsestidh	jop^tses^tidh
jorkesidh	jor^ke^sidh
jorpesjidh	jor^pe^sjidh
jorpestidh	jor^pes^tidh
jortehtidh	jor^teh^tidh
jotskedidh	jots^ke^didh
jotskelidh	jots^ke^lidh
jovkehtidh	jov^keh^tidh
jovkelidh	jov^ke^lidh
jovkestidh	jov^kes^tidh
jovsedidh	jov^se^didh
juakadidh	jua^ka^didh
juekiestidh	jue^kies^tidh
jueriedidh	jue^rie^didh
jueskiehtidh	jues^kieh^tidh
juhtiehtidh	juh^tieh^tidh
juhtielidh	juh^tie^lidh
juhtiestidh	juh^ties^tidh
juktiestidh	juk^ties^tidh
julliedidh	jul^lie^didh
jullierdidh	jul^lier^didh
jurjiehtidh	jur^jieh^tidh
jurrieldidh	jur^riel^didh
juvnehtidh	juv^neh^tidh
jyörehtidh	jyö^reh^tidh
jyörkesjidh	jyör^ke^sjidh
jåamahtidh	jåa^mah^tidh
jåasadidh	jåa^sa^didh
jåasaridh	jåa^sa^ridh
jåaskadidh	jåas^ka^didh
jåaskastidh	jåas^kas^tidh
jåaskoedidh	jåas^koe^didh
jåaskoestidh	jåas^koes^tidh
jåebpiedidh	jåeb^pie^didh
jåepiedidh	jåe^pie^didh
jåerhkiestidh	jåerh^kies^tidh
jåeskiehtidh	jåes^kieh^tidh
jåhtajidh	jåh^ta^jidh
jållaridh	jål^la^ridh
jålmoedidh	jål^moe^didh
jålmoehtidh	jål^moeh^tidh
jårkoehtidh	jår^koeh^tidh
jårralidh	jår^ra^lidh
jårrehtidh	jår^reh^tidh
jårrelidh	jår^re^lidh
jårrestidh	jår^res^tidh
jåtskoedidh	jåts^koe^didh
jåvkelidh	jåv^ke^lidh
jååhkesjidh	jååh^ke^sjidh
jååkedidh	jåå^ke^didh
jååkestidh	jåå^kes^tidh
jååpedidh	jåå^pe^didh
jåårkesjidh	jåår^ke^sjidh
jæjhtajidh	jæjh^ta^jidh
jætnasjidh	jæt^na^sjidh
jïdtehtidh	jïd^teh^tidh
jïegkedidh	jïeg^ke^didh
jïegkedidh	jïeg^ke^didh
jïegkemidh	jïeg^ke^midh
jïegkenidh	jïeg^ke^nidh
jïeledidh	jïe^le^didh
jïemmerdidh	jïem^mer^didh
jïemperdidh	jïem^per^didh
jïengedidh	jïe^nge^didh
jïepkenidh	jïep^ke^nidh
jïepkerdidh	jïep^ker^didh
jïerenidh	jïe^re^nidh
jïermestidh	jïer^mes^tidh
jïevehtidh	jïe^veh^tidh
jïevkehtidh	jïev^keh^tidh
jïjhtelidh	jïjh^te^lidh
jïjjedidh	jïj^je^didh
jïjjehtidh	jïj^jeh^tidh
jïjnedidh	jïj^ne^didh
jïjnestidh	jïj^nes^tidh
jïllerdidh	jïl^ler^didh
jïrhvestidh	jïrh^ves^tidh
jïrvestidh	jïr^ves^tidh
jööjjeldidh	jööj^jel^didh
jöövelidh	jöö^ve^lidh
kaarhtedidh	kaarh^te^didh
kaarhtedidh	kaarh^te^didh
kaarhtedidh	kaarh^te^didh
klaadtenidh	klaad^te^nidh
klaahkesjidh	klaah^ke^sjidh
klaahkestidh	klaah^kes^tidh
klaahterdidh	klaah^ter^didh
klaamperdidh	klaam^per^didh
klaaterdidh	klaa^ter^didh
klaehkiestidh	klaeh^kies^tidh
klaeriedidh	klae^rie^didh
klahkestidh	klah^kes^tidh
klajkesidh	klaj^ke^sidh
klajkoehtidh	klaj^koeh^tidh
klavhnjanidh	klavh^nja^nidh
klavjasjidh	klav^ja^sjidh
kleavvasjidh	kleav^va^sjidh
kleenghkestidh	kleengh^kes^tidh
kleevvehtidh	kleev^veh^tidh
klevjiedidh	klev^jie^didh
klienjiedidh	klie^njie^didh
kliktjiestidh	klik^tjies^tidh
klintjehtidh	klin^tjeh^tidh
klintjestidh	klin^tjes^tidh
klitnjiedidh	klit^njie^didh
klitnjiestidh	klit^njies^tidh
klobpegidh	klob^pe^gidh
klobpesjidh	klob^pe^sjidh
klohterdidh	kloh^ter^didh
klomhpehtidh	klomh^peh^tidh
klommerdidh	klom^mer^didh
klovhnjehtidh	klovh^njeh^tidh
klovperdidh	klov^per^didh
kluhtierdidh	kluh^tier^didh
klumhpiehtidh	klumh^pieh^tidh
klungkiestidh	klung^kies^tidh
klygkerdidh	klyg^ker^didh
klytnjegidh	klyt^nje^gidh
klyövkestidh	klyöv^kes^tidh
klåamsahtidh	klåam^sah^tidh
klåamsoehtidh	klåam^soeh^tidh
klåenkiehtidh	klåen^kieh^tidh
klåvparidh	klåv^pa^ridh
klååhkesjidh	klååh^ke^sjidh
klååhkestidh	klååh^kes^tidh
klååmsedidh	klååm^se^didh
klæhtoehtidh	klæh^toeh^tidh
klæjhpoedidh	klæjh^poe^didh
klæmhpadidh	klæmh^pa^didh
klïevvestidh	klïev^ves^tidh
klïmhpesjidh	klïmh^pe^sjidh
klïpmehtidh	klïp^meh^tidh
klööstedidh	klöös^te^didh
klöösterdidh	klöös^ter^didh
knogkesjidh	knog^ke^sjidh
knïjhtjehtidh	knïjht^jeh^tidh
kraakoejidh	kraa^koe^jidh
kraaksasjidh	kraak^sa^sjidh
kraamedidh	kraa^me^didh
kraaptjasidh	kraap^tja^sidh
kraavhkedidh	kraavh^ke^didh
kraavhkehtidh	kraavh^keh^tidh
kraavhkesidh	kraavh^ke^sidh
kraavhkestidh	kraavh^kes^tidh
kraavkesjidh	kraav^ke^sjidh
kraavkestidh	kraav^kes^tidh
kradtjoehtidh	krad^tjoeh^tidh
kraemhkiedidh	kraemh^kie^didh
kraemhkiehtidh	kraemh^kieh^tidh
kraemhkiestidh	kraemh^kies^tidh
kraesiedidh	krae^sie^didh
kraevkiehtidh	kraev^kieh^tidh
kraevkiestidh	kraev^kies^tidh
krakngahtidh	krak^ngah^tidh
krakngaridh	krak^nga^ridh
krakngasjidh	krak^nga^sjidh
kramhkesidh	kramh^ke^sidh
kramhkestidh	kramh^kes^tidh
kranghkestidh	krangh^kes^tidh
kranhtjaridh	kranht^ja^ridh
kranhtjasjidh	kranht^ja^sjidh
kravvadidh	krav^va^didh
kravvadidh	krav^va^didh
kreajnahtidh	kreaj^nah^tidh
kreajnoehtidh	kreaj^noeh^tidh
kreanghkasjidh	kreangh^ka^sjidh
kreanhtjaridh	kreanht^ja^ridh
kreavkedidh	kreav^ke^didh
kreavkestidh	kreav^kes^tidh
kreebpedidh	kreeb^pe^didh
kreebpestidh	kreeb^pes^tidh
kreenghkestidh	kreengh^kes^tidh
kreeptjedidh	kreep^tje^didh
kreeptjestidh	kreep^tjes^tidh
krekngiehtidh	krek^ngieh^tidh
kremhkiehtidh	kremh^kieh^tidh
krenhtjierdidh	krenht^jier^didh
krevviedidh	krev^vie^didh
krijhtjehtidh	krijht^jeh^tidh
kringkiestidh	kring^kies^tidh
krinkesjidh	krin^ke^sjidh
kritskesidh	krits^ke^sidh
kritskiestidh	krits^kies^tidh
krodtesjidh	krod^te^sjidh
kroehkestidh	kroeh^kes^tidh
kroenedidh	kroe^ne^didh
kroetskestidh	kroets^kes^tidh
krogkesjidh	krog^ke^sjidh
krogkestidh	krog^kes^tidh
krokngedidh	krok^nge^didh
krokngegidh	krok^nge^gidh
krokngesjidh	krok^nge^sjidh
kronhtjegidh	kronht^je^gidh
kronhtjehtidh	kronht^jeh^tidh
kropmesjidh	krop^me^sjidh
kruanasjidh	krua^na^sjidh
kruassjasjidh	kruas^sja^sjidh
kruehkiehtidh	krueh^kieh^tidh
kruemiehtidh	krue^mieh^tidh
krukngiehtidh	kruk^ngieh^tidh
krumhkiestidh	krumh^kies^tidh
krungkestidh	krung^kes^tidh
krunhtjegidh	krunht^je^gidh
krunhtjestidh	krunht^jes^tidh
kruvhkedidh	kruvh^ke^didh
kruvhkestidh	kruvh^kes^tidh
kråabjegidh	kråab^je^gidh
kråahkahtidh	kråah^kah^tidh
kråahkasjidh	kråah^ka^sjidh
kråahkoehtidh	kråah^koeh^tidh
kråakesjidh	kråa^ke^sjidh
kråamahtidh	kråa^mah^tidh
kråatskestidh	kråats^kes^tidh
kråavhkasjidh	kråavh^ka^sjidh
kråavvahtidh	kråav^vah^tidh
kråavvaridh	kråav^va^ridh
kråavvasjidh	kråav^va^sjidh
kråavvegidh	kråav^ve^gidh
kråavvoedidh	kråav^voe^didh
kråavvoehtidh	kråav^voeh^tidh
kråevviehtidh	kråev^vieh^tidh
kråkngasjidh	kråk^nga^sjidh
kråånedidh	kråå^ne^didh
krååvedidh	kråå^ve^didh
krååvvedidh	krååv^ve^didh
kræjhtjadidh	kræjht^ja^didh
krænhtjaridh	krænht^ja^ridh
krænhtjasjidh	krænht^ja^sjidh
krænkasjidh	kræn^ka^sjidh
krïbpesjidh	krïb^pe^sjidh
krïebpesjidh	krïeb^pe^sjidh
krïntestidh	krïn^tes^tidh
krïtjkehtidh	krïtj^keh^tidh
krööhkestidh	krööh^kes^tidh
kröövvedidh	krööv^ve^didh
kröövvehtidh	krööv^veh^tidh
kröövvestidh	krööv^ves^tidh
kvæhkanidh	kvæh^ka^nidh
kåvrahtidh	kåv^rah^tidh
köörredidh	köör^re^didh
laabjehtidh	laab^jeh^tidh
laabpanidh	laab^pa^nidh
laabpestidh	laab^pes^tidh
laabregidh	laab^re^gidh
laabtjoestidh	laab^tjoes^tidh
laahkoestidh	laah^koes^tidh
laahpehtidh	laah^peh^tidh
laajhnadidh	laajh^na^didh
laakestidh	laa^kes^tidh
laamoehtidh	laa^moeh^tidh
laanestidh	laa^nes^tidh
laapestidh	laa^pes^tidh
laarhkasidh	laarh^ka^sidh
laarhkenidh	laarh^ke^nidh
laatjmoedidh	laatj^moe^didh
laatkanidh	laat^ka^nidh
laavkastidh	laav^kas^tidh
laavkedidh	laav^ke^didh
laavkelidh	laav^ke^lidh
laavkestidh	laav^kes^tidh
laavkoestidh	laav^koes^tidh
laavlesidh	laav^le^sidh
labnjestidh	lab^njes^tidh
laegkiestidh	laeg^kies^tidh
laehkiedidh	laeh^kie^didh
laehkiehtidh	laeh^kieh^tidh
laehpielidh	laeh^pie^lidh
laejjiedidh	laej^jie^didh
laejviehtidh	laej^vieh^tidh
laekiestidh	lae^kies^tidh
laemtjiestidh	laem^tjies^tidh
laeviehtidh	lae^vieh^tidh
laeviestidh	lae^vies^tidh
lahkanidh	lah^ka^nidh
lahkaskidh	lah^kas^kidh
lahkesidh	lah^ke^sidh
lahkoehtidh	lah^koeh^tidh
lahtestidh	lah^tes^tidh
lajkasidh	laj^ka^sidh
lajkesidh	laj^ke^sidh
lamkasjidh	lam^ka^sjidh
lamkedidh	lam^ke^didh
lamkestidh	lam^kes^tidh
lanhkesidh	lanh^ke^sidh
lankasidh	lan^ka^sidh
lapkelidh	lap^ke^lidh
laptahtidh	lap^tah^tidh
laptehtidh	lap^teh^tidh
larhkahtidh	larh^kah^tidh
larhkelidh	larh^ke^lidh
laskasjidh	las^ka^sjidh
latkahtidh	lat^kah^tidh
latkalidh	lat^ka^lidh
lavmoestidh	lav^moes^tidh
lavnedidh	lav^ne^didh
lavnestidh	lav^nes^tidh
leagkasidh	leag^ka^sidh
leagkehtidh	leag^keh^tidh
leahtadidh	leah^ta^didh
leajhkasidh	leajh^ka^sidh
leajhtadidh	leajh^ta^didh
leajmoedidh	leaj^moe^didh
leajpaskidh	leaj^pas^kidh
leajpedidh	leaj^pe^didh
leajpoestidh	leaj^poes^tidh
leakadidh	lea^ka^didh
leamkelidh	leam^ke^lidh
leamoedidh	lea^moe^didh
leamoestidh	lea^moes^tidh
leantanidh	lean^ta^nidh
learhkelidh	learh^ke^lidh
learhvanidh	learh^va^nidh
leavadidh	lea^va^didh
leavehtidh	lea^veh^tidh
leavlanidh	leav^la^nidh
leavradidh	leav^ra^didh
ledtiehtidh	led^tieh^tidh
leebpestidh	leeb^pes^tidh
leegrehtidh	leeg^reh^tidh
leehpehtidh	leeh^peh^tidh
leejhkestidh	leejh^kes^tidh
leejjestidh	leej^jes^tidh
leekedidh	lee^ke^didh
leekestidh	lee^kes^tidh
leenestidh	lee^nes^tidh
leengkestidh	leeng^kes^tidh
leerehtidh	lee^reh^tidh
leerhkedidh	leerh^ke^didh
leerhkehtidh	leerh^keh^tidh
leetkedidh	leet^ke^didh
lenhkiehtidh	lenh^kieh^tidh
lenhkiestidh	lenh^kies^tidh
lenkiehtidh	len^kieh^tidh
lenkiestidh	len^kies^tidh
leskiestidh	les^kies^tidh
libnjiedidh	lib^njie^didh
libnjiestidh	lib^njies^tidh
libredidh	lib^re^didh
liemkiedidh	liem^kie^didh
liemkiehtidh	liem^kieh^tidh
lierhkiehtidh	lierh^kieh^tidh
lieskiestidh	lies^kies^tidh
lietskiehtidh	liets^kieh^tidh
lievhkiehtidh	lievh^kieh^tidh
lievkiehtidh	liev^kieh^tidh
lievkiestidh	liev^kies^tidh
lievliedidh	liev^lie^didh
lievliedidh	liev^lie^didh
lijjesjidh	lij^je^sjidh
lijrehtidh	lij^reh^tidh
lijrestidh	lij^res^tidh
limkedidh	lim^ke^didh
limkesjidh	lim^ke^sjidh
limkestidh	lim^kes^tidh
lissiehtidh	lis^sieh^tidh
lissiehtidh	lis^sieh^tidh
loebpedidh	loeb^pe^didh
loebpegidh	loeb^pe^gidh
loebpenidh	loeb^pe^nidh
loedtelidh	loed^te^lidh
loedtenidh	loed^te^nidh
loegkedidh	loeg^ke^didh
loegkehtidh	loeg^keh^tidh
loegkesidh	loeg^ke^sidh
loegkestidh	loeg^kes^tidh
loehtjedidh	loeh^tje^didh
loejhtedidh	loejh^te^didh
loejhtelidh	loejh^te^lidh
loepedidh	loe^pe^didh
loerhkehtidh	loerh^keh^tidh
loesmegidh	loes^me^gidh
loesmestidh	loes^mes^tidh
loetedidh	loe^te^didh
loetestidh	loe^tes^tidh
loevenidh	loe^ve^nidh
loevesjidh	loe^ve^sjidh
lohkehtidh	loh^keh^tidh
lohkestidh	loh^kes^tidh
lokngenidh	lok^nge^nidh
lokngesidh	lok^nge^sidh
lotkeridh	lot^ke^ridh
lotnedidh	lot^ne^didh
lovrehtidh	lov^reh^tidh
lovsehtidh	lov^seh^tidh
lovterdidh	lov^ter^didh
lovvedidh	lov^ve^didh
lovvehtidh	lov^veh^tidh
lovvesjidh	lov^ve^sjidh
luagkanidh	luag^ka^nidh
luajhtadidh	luajh^ta^didh
luajhtaridh	luajh^ta^ridh
luapasidh	lua^pa^sidh
luapaskidh	lua^pas^kidh
luebpiehtidh	lueb^pieh^tidh
luejhtielidh	luejh^tie^lidh
luejhtiestidh	luejh^ties^tidh
luevhkiehtidh	luevh^kieh^tidh
luevliedidh	luev^lie^didh
luhpiedidh	luh^pie^didh
luhpiehtidh	luh^pieh^tidh
luhpieridh	luh^pie^ridh
luknjestidh	luk^njes^tidh
luptestidh	lup^tes^tidh
lutniestidh	lut^nies^tidh
lutnjestidh	lut^njes^tidh
lutnjiestidh	lut^njies^tidh
luvdiedidh	luv^die^didh
luvliehtidh	luv^lieh^tidh
luvliestidh	luv^lies^tidh
luvriedidh	luv^rie^didh
luvsedidh	luv^se^didh
lygnestidh	lyg^nes^tidh
lyhkesidh	lyh^ke^sidh
lyhkestidh	lyh^kes^tidh
lyhpehtidh	lyh^peh^tidh
lyjhkedidh	lyjh^ke^didh
lyjhkestidh	lyjh^kes^tidh
lyjjesjidh	lyj^je^sjidh
lyvterdidh	lyv^ter^didh
lyvvedidh	lyv^ve^didh
lyvvesjidh	lyv^ve^sjidh
lyöjhkesidh	lyöjh^ke^sidh
lyövledidh	lyöv^le^didh
låablesidh	låab^le^sidh
låabpedidh	låab^pe^didh
låadtedidh	låad^te^didh
låamedidh	låa^me^didh
låapahtidh	låa^pah^tidh
låapastidh	låa^pas^tidh
låapoehtidh	låa^poeh^tidh
låasedidh	låa^se^didh
låaskelidh	låas^ke^lidh
låavkelidh	låav^ke^lidh
låavtestidh	låav^tes^tidh
låebliedidh	låeb^lie^didh
låebliedidh	låeb^lie^didh
låegkiestidh	låeg^kies^tidh
låepiehtidh	låe^pieh^tidh
låesjiemgidh	låe^sjiem^gidh
låevkiehtidh	låev^kieh^tidh
låpsoedidh	låp^soe^didh
låtnoehtidh	låt^noeh^tidh
låvnestidh	låv^nes^tidh
lååjedidh	låå^je^didh
lååjkedidh	lååj^ke^didh
lååjkeridh	lååj^ke^ridh
låånestidh	låå^nes^tidh
lååpesidh	låå^pe^sidh
lååskehtidh	låås^keh^tidh
lååvesjidh	låå^ve^sjidh
læbraskidh	læb^ras^kidh
læhkadidh	læh^ka^didh
læhkaskidh	læh^kas^kidh
læhkoehtidh	læh^koeh^tidh
læhkoeskidh	læh^koes^kidh
læhkoestidh	læh^koes^tidh
læhpasjidh	læh^pa^sjidh
læjjadidh	læj^ja^didh
læjjoestidh	læj^joes^tidh
læjkahtidh	læj^kah^tidh
læjkaridh	læj^ka^ridh
læjkoedidh	læj^koe^didh
læjnoedidh	læj^noe^didh
længhkahtidh	længh^kah^tidh
længhkoehtidh	længh^koeh^tidh
længhkoestidh	længh^koes^tidh
læssamidh	læs^sa^midh
læssanidh	læs^sa^nidh
lïegkedidh	lïeg^ke^didh
lïegkehtidh	lïeg^keh^tidh
lïegkelidh	lïeg^ke^lidh
lïegkenidh	lïeg^ke^nidh
lïegkeridh	lïeg^ke^ridh
lïegkesidh	lïeg^ke^sidh
lïegkestidh	lïeg^kes^tidh
lïehtesjidh	lïeh^te^sjidh
lïejhkesidh	lïejh^ke^sidh
lïejpedidh	lïej^pe^didh
lïemkelidh	lïem^ke^lidh
lïenedidh	lïe^ne^didh
lïenedidh	lïe^ne^didh
lïenelidh	lïe^ne^lidh
lïenemidh	lïe^ne^midh
lïerehtidh	lïe^reh^tidh
lïerelidh	lïe^re^lidh
lïerhkelidh	lïerh^ke^lidh
lïerhvehtidh	lïerh^veh^tidh
lïestestidh	lïes^tes^tidh
lïevhkelidh	lïevh^ke^lidh
lïevhkesjidh	lïevh^ke^sjidh
lïevkesidh	lïev^ke^sidh
lïgkedidh	lïg^ke^didh
lïgkelidh	lïg^ke^lidh
lïhkedidh	lïh^ke^didh
lïhtsestidh	lïh^tses^tidh
lïjmedidh	lïj^me^didh
lïjmesjidh	lïj^me^sjidh
lïjmestidh	lïj^mes^tidh
lïnghkegidh	lïngh^ke^gidh
lïnghkehtidh	lïngh^keh^tidh
lïnghkesidh	lïngh^ke^sidh
lïnghkestidh	lïngh^kes^tidh
lööbpestidh	lööb^pes^tidh
löödtestidh	lööd^tes^tidh
löödtjehtidh	lööd^tjeh^tidh
löödtjemidh	lööd^tje^midh
löödtjestidh	lööd^tjes^tidh
löönedidh	löö^ne^didh
löönelidh	löö^ne^lidh
löönestidh	löö^nes^tidh
lööveldidh	löö^vel^didh
maadtestidh	maad^tes^tidh
maahtsehtidh	maah^tseh^tidh
maahtsoestidh	maah^tsoes^tidh
maajkestidh	maaj^kes^tidh
maajverdidh	maaj^ver^didh
maaktadidh	maak^ta^didh
maarhvestidh	maarh^ves^tidh
maarngastidh	maar^ngas^tidh
maarngestidh	maar^nges^tidh
maaskanidh	maas^ka^nidh
maaskenidh	maas^ke^nidh
maaskesidh	maas^ke^sidh
maatadidh	maa^ta^didh
madtjastidh	mad^tjas^tidh
madtjeldidh	mad^tjel^didh
madtjelidh	mad^tje^lidh
madtsastidh	mad^tsas^tidh
maedtiestidh	maed^ties^tidh
maehtjierdidh	maeh^tjier^didh
maejkiehtidh	maej^kieh^tidh
maeliestidh	mae^lies^tidh
maerhviestidh	maerh^vies^tidh
maeriehtidh	mae^rieh^tidh
magkalidh	mag^ka^lidh
mahtaridh	mah^ta^ridh
mahtjaldidh	mah^tjal^didh
mahtjalidh	mah^tja^lidh
majkestidh	maj^kes^tidh
maljardidh	ma^ljar^didh
maljargidh	ma^ljar^gidh
maljaridh	ma^lja^ridh
maljerdidh	ma^ljer^didh
malkanidh	mal^ka^nidh
malkenidh	mal^ke^nidh
malsastidh	mal^sas^tidh
mannahtidh	man^nah^tidh
marhkanidh	marh^ka^nidh
marhtjestidh	marht^jes^tidh
marngasidh	mar^nga^sidh
marngastidh	mar^ngas^tidh
marngegidh	mar^nge^gidh
marngesidh	mar^nge^sidh
marngestidh	mar^nges^tidh
marradidh	mar^ra^didh
marrahtidh	mar^rah^tidh
marregidh	mar^re^gidh
marrehtidh	mar^reh^tidh
maskastidh	mas^kas^tidh
mastelidh	mas^te^lidh
matkanidh	mat^ka^nidh
meahtjanidh	meah^tja^nidh
meahtsanidh	meah^tsa^nidh
mealtjehtidh	meal^tjeh^tidh
mearhkesjidh	mearh^ke^sjidh
meatadidh	mea^ta^didh
meejvehtidh	meej^veh^tidh
meelestidh	mee^les^tidh
meerestidh	mee^res^tidh
mejkiehtidh	mej^kieh^tidh
mejkiestidh	mej^kies^tidh
meksiehtidh	mek^sieh^tidh
meljierdidh	me^ljier^didh
miedtielidh	mied^tie^lidh
miehtjiedidh	mieh^tjie^didh
miehtjiedidh	mieh^tjie^didh
miejkiehtidh	miej^kieh^tidh
mieriedidh	mie^rie^didh
mietiedidh	mie^tie^didh
mietiehtidh	mie^tieh^tidh
mievriestidh	miev^ries^tidh
mievvierdidh	miev^vier^didh
mirngestidh	mir^nges^tidh
mistehtidh	mis^teh^tidh
modtedidh	mod^te^didh
moenedidh	moe^ne^didh
moenjedidh	moe^nje^didh
moenjehtidh	moe^njeh^tidh
moenjesjidh	moe^nje^sjidh
moentedidh	moen^te^didh
moerkestidh	moer^kes^tidh
moeseridh	moe^se^ridh
moetesjidh	moe^te^sjidh
moeveldidh	moe^vel^didh
mohkerdidh	moh^ker^didh
mohtedidh	moh^te^didh
mohtjelidh	moh^tje^lidh
mojhtelidh	mojh^te^lidh
mojhtestidh	mojh^tes^tidh
mojjehtidh	moj^jeh^tidh
mojjesidh	moj^je^sidh
mojjestidh	moj^jes^tidh
mojnesjidh	moj^ne^sjidh
mojnestidh	moj^nes^tidh
mojvenidh	moj^ve^nidh
molledidh	mol^le^didh
molskenidh	mol^ske^nidh
moltestidh	mol^tes^tidh
mommeldidh	mom^mel^didh
monghkestidh	mongh^kes^tidh
morhtjegidh	morht^je^gidh
morvegidh	mor^ve^gidh
moskesidh	mos^ke^sidh
mosnestidh	mos^nes^tidh
mualhnjasjidh	mualh^nja^sjidh
mualhvasjidh	mualh^va^sjidh
muavasidh	mua^va^sidh
muavaskidh	mua^vas^kidh
mubpiestidh	mub^pies^tidh
mudtedidh	mud^te^didh
mudtestidh	mud^tes^tidh
muegkiedidh	mueg^kie^didh
muerkiestidh	muer^kies^tidh
mujhtiehtidh	mujh^tieh^tidh
mujhtiestidh	mujh^ties^tidh
mujjehtidh	muj^jeh^tidh
mulliedidh	mul^lie^didh
mulliedidh	mul^lie^didh
mulliehtidh	mul^lieh^tidh
multjiestidh	mul^tjies^tidh
murhkestidh	murh^kes^tidh
murhkiehtidh	murh^kieh^tidh
murhtjehtidh	murht^jeh^tidh
murkiestidh	mur^kies^tidh
murriedidh	mur^rie^didh
murvehtidh	mur^veh^tidh
musniedidh	mus^nie^didh
mutskiehtidh	muts^kieh^tidh
muvriedidh	muv^rie^didh
muvvestidh	muv^ves^tidh
myvvedidh	myv^ve^didh
myövhkedidh	myövh^ke^didh
måadtoedidh	måad^toe^didh
måadtoehtidh	måad^toeh^tidh
måahtadidh	måah^ta^didh
måajhtasidh	måajh^ta^sidh
måajhtaskidh	måajh^tas^kidh
måajoestidh	måa^joes^tidh
måakoedidh	måa^koe^didh
måaladidh	måa^la^didh
måalehtidh	måa^leh^tidh
måalhnjasjidh	måalh^nja^sjidh
måanhtjesjidh	måanht^je^sjidh
måaroedidh	måa^roe^didh
måasadidh	måa^sa^didh
måasahtidh	måa^sah^tidh
måasaridh	måa^sa^ridh
måasastidh	måa^sas^tidh
måaskajidh	måas^ka^jidh
måaskasjidh	måas^ka^sjidh
måaskelidh	måas^ke^lidh
måasoedidh	måa^soe^didh
måaveldidh	måa^vel^didh
mådtoestidh	måd^toes^tidh
mådtsoestidh	måd^tsoes^tidh
måelhkiehtidh	måelh^kieh^tidh
måelliedidh	måel^lie^didh
måeskiehtidh	måes^kieh^tidh
måjhtajidh	måjh^ta^jidh
måjhtalidh	måjh^ta^lidh
måjhtelidh	måjh^te^lidh
måjkoedidh	måj^koe^didh
målhtjaridh	målht^ja^ridh
målloedidh	mål^loe^didh
målsoehtidh	mål^soeh^tidh
målsoelidh	mål^soe^lidh
målsoestidh	mål^soes^tidh
månghkasjidh	mångh^ka^sjidh
månnoedidh	mån^noe^didh
månnoehtidh	mån^noeh^tidh
mårhkanidh	mårh^ka^nidh
mårhtjoedidh	mårht^joe^didh
mårradidh	mår^ra^didh
mårrahtidh	mår^rah^tidh
mårregidh	mår^re^gidh
mårrehtidh	mår^reh^tidh
måskoestidh	mås^koes^tidh
måvhtadidh	måvh^ta^didh
måvladidh	måv^la^didh
måvvalidh	måv^va^lidh
mååjkesidh	mååj^ke^sidh
mååjsedidh	mååj^se^didh
måårngesidh	måår^nge^sidh
mååskesjidh	måås^ke^sjidh
mååssjeridh	måås^sje^ridh
mæjjasjidh	mæj^ja^sjidh
mæjjesjidh	mæj^je^sjidh
mæjtasjidh	mæj^ta^sjidh
mæjtsasjidh	mæj^tsa^sjidh
mængkadidh	mæng^ka^didh
mængkanidh	mæng^ka^nidh
mænnganidh	mæn^nga^nidh
mïedtelidh	mïed^te^lidh
mïedtesidh	mïed^te^sidh
mïehtesjidh	mïeh^te^sjidh
mïehtestidh	mïeh^tes^tidh
mïeltjegidh	mïel^tje^gidh
mïeltjehtidh	mïel^tjeh^tidh
mïerhkesjidh	mïerh^ke^sjidh
mïertsehtidh	mïer^tseh^tidh
mïesesjidh	mïe^se^sjidh
mïetestidh	mïe^tes^tidh
mïetskenidh	mïets^ke^nidh
mïevredidh	mïev^re^didh
mïlskenidh	mïl^ske^nidh
mïnnedidh	mïn^ne^didh
mïnnijidh	mïn^ni^jidh
möökestidh	möö^kes^tidh
möölehtidh	möö^leh^tidh
naajestidh	naa^jes^tidh
naajhkehtidh	naajh^keh^tidh
naajhkesidh	naajh^ke^sidh
naaledidh	naa^le^didh
naalenidh	naa^le^nidh
naaloedidh	naa^loe^didh
naamesjidh	naa^me^sjidh
naapeldidh	naa^pel^didh
naaperdidh	naa^per^didh
naavlehtidh	naav^leh^tidh
naavlesjidh	naav^le^sjidh
naehkielidh	naeh^kie^lidh
naepieldidh	nae^piel^didh
naepierdidh	nae^pier^didh
naevieldidh	nae^viel^didh
nahkasjidh	nah^ka^sjidh
nahkedidh	nah^ke^didh
nahkerdidh	nah^ker^didh
nahkestidh	nah^kes^tidh
nahkoehtidh	nah^koeh^tidh
nahtadidh	nah^ta^didh
nahtedidh	nah^te^didh
najkesidh	naj^ke^sidh
najladidh	naj^la^didh
najvanidh	naj^va^nidh
najvegidh	naj^ve^gidh
najvehtidh	naj^veh^tidh
nalhkedidh	nalh^ke^didh
nalhkelidh	nalh^ke^lidh
naljastidh	na^ljas^tidh
namhpestidh	namh^pes^tidh
nammahtidh	nam^mah^tidh
nammoehtidh	nam^moeh^tidh
namtestidh	nam^tes^tidh
napkalidh	nap^ka^lidh
napkasidh	nap^ka^sidh
narhkelidh	narh^ke^lidh
narhkoehtidh	narh^koeh^tidh
narhtelidh	narh^te^lidh
narhtoelidh	narh^toe^lidh
narrahtidh	nar^rah^tidh
narrasidh	nar^ra^sidh
narrastidh	nar^ras^tidh
narresidh	nar^re^sidh
narrestidh	nar^res^tidh
nartehtidh	nar^teh^tidh
narteldidh	nar^tel^didh
nartelidh	nar^te^lidh
naskahtidh	nas^kah^tidh
naskoehtidh	nas^koeh^tidh
nassedidh	nas^se^didh
nastestidh	nas^tes^tidh
natskehtidh	nats^keh^tidh
natskesidh	nats^ke^sidh
navhkesidh	navh^ke^sidh
navnasjidh	nav^na^sjidh
navrehtidh	nav^reh^tidh
navtedidh	nav^te^didh
neajhkestidh	neajh^kes^tidh
neajhpanidh	neajh^pa^nidh
neajpanidh	neaj^pa^nidh
nealkoedidh	neal^koe^didh
neantoedidh	nean^toe^didh
nearrahtidh	near^rah^tidh
neejpesjidh	neej^pe^sjidh
neelelidh	nee^le^lidh
neerrehtidh	neer^reh^tidh
nehkiehtidh	neh^kieh^tidh
nehkielidh	neh^kie^lidh
nehpieldidh	neh^piel^didh
nejhkiestidh	nejh^kies^tidh
nejjiedidh	nej^jie^didh
nelhkiehtidh	nelh^kieh^tidh
nelhkiestidh	nelh^kies^tidh
nellielidh	nel^lie^lidh
nepkiehtidh	nep^kieh^tidh
netskiestidh	nets^kies^tidh
nevviehtidh	nev^vieh^tidh
niejestidh	nie^jes^tidh
niejhkiestidh	niejh^kies^tidh
nierhkedidh	nierh^ke^didh
nihkierdidh	nih^kier^didh
nihtielidh	nih^tie^lidh
nijjelidh	nij^je^lidh
nijvestidh	nij^ves^tidh
nimhpestidh	nimh^pes^tidh
njaabpehtidh	njaab^peh^tidh
njaakedidh	njaa^ke^didh
njaakelidh	njaa^ke^lidh
njaalmedidh	njaal^me^didh
njaamedidh	njaa^me^didh
njaamestidh	njaa^mes^tidh
njaarehtidh	njaa^reh^tidh
njaarvanidh	njaar^va^nidh
njaatsoedidh	njaa^tsoe^didh
njaaverdidh	njaa^ver^didh
njaavhkehtidh	njaavh^keh^tidh
njabpedidh	njab^pe^didh
njabpestidh	njab^pes^tidh
njadkelidh	njad^ke^lidh
njadtsasidh	njad^tsa^sidh
njadtsesidh	njad^tse^sidh
njaelkiedidh	njael^kie^didh
njaerviehtidh	njaer^vieh^tidh
njahkasjidh	njah^ka^sjidh
njahpedidh	njah^pe^didh
njahpehtidh	njah^peh^tidh
njahpestidh	njah^pes^tidh
njajhkehtidh	njajh^keh^tidh
njajhkesidh	njajh^ke^sidh
njajkasjidh	njaj^ka^sjidh
njaktsasidh	njak^tsa^sidh
njalhkedidh	njalh^ke^didh
njalhkedidh	njalh^ke^didh
njalhkestidh	njalh^kes^tidh
njalhkestidh	njalh^kes^tidh
njalkelidh	njal^ke^lidh
njallasidh	njal^la^sidh
njallastidh	njal^las^tidh
njalleridh	njal^le^ridh
njallesidh	njal^le^sidh
njalloestidh	njal^loes^tidh
njaltasidh	njal^ta^sidh
njamkehtidh	njam^keh^tidh
njamkelidh	njam^ke^lidh
njammestidh	njam^mes^tidh
njarhvestidh	njarh^ves^tidh
njarkahtidh	njar^kah^tidh
njarkehtidh	njar^keh^tidh
njarraridh	njar^ra^ridh
njassedidh	njas^se^didh
njavhkehtidh	njavh^keh^tidh
njavvagidh	njav^va^gidh
njavvaridh	njav^va^ridh
njavverdidh	njav^ver^didh
njeajhkasjidh	njeajh^ka^sjidh
njeajhpanidh	njeajh^pa^nidh
njeajkalidh	njeaj^ka^lidh
njealtasidh	njeal^ta^sidh
njeanoehtidh	njea^noeh^tidh
njebpiehtidh	njeb^pieh^tidh
njeervelidh	njeer^ve^lidh
njehpieldidh	njeh^piel^didh
njektjiestidh	njek^tjies^tidh
njelliestidh	njel^lies^tidh
njemhkiehtidh	njemh^kieh^tidh
njemkehtidh	njem^keh^tidh
njemkiehtidh	njem^kieh^tidh
njevviestidh	njev^vies^tidh
njiblestidh	njib^les^tidh
njiejkiehtidh	njiej^kieh^tidh
njieskiehtidh	njies^kieh^tidh
njievkerdidh	njiev^ker^didh
njihpieldidh	njih^piel^didh
njilkehtidh	njil^keh^tidh
njilkelidh	njil^ke^lidh
njilliedidh	njil^lie^didh
njilliedidh	njil^lie^didh
njilliestidh	njil^lies^tidh
njimkehtidh	njim^keh^tidh
njiskiehtidh	njis^kieh^tidh
njoejjegidh	njoej^je^gidh
njoeledidh	njoe^le^didh
njoenerdidh	njoe^ner^didh
njoerenidh	njoe^re^nidh
njoetestidh	njoe^tes^tidh
njoevestidh	njoe^ves^tidh
njoevtesjidh	njoev^te^sjidh
njoktsesidh	njok^tse^sidh
njorkedidh	njor^ke^didh
njorkesjidh	njor^ke^sjidh
njotsvegidh	njots^ve^gidh
njovhkedidh	njovh^ke^didh
njovhkehtidh	njovh^keh^tidh
njuajjaridh	njuaj^ja^ridh
njuajjasjidh	njuaj^ja^sjidh
njulhtjedidh	njulht^je^didh
njulhtjestidh	njulht^jes^tidh
njuvtielidh	njuv^tie^lidh
njyjjehtidh	njyj^jeh^tidh
njyllesjidh	njyl^le^sjidh
njyöltesidh	njyöl^te^sidh
njåajjaridh	njåaj^ja^ridh
njåaloestidh	njåa^loes^tidh
njåalvoestidh	njåal^voes^tidh
njåamasjidh	njåa^ma^sjidh
njåamestidh	njåa^mes^tidh
njåamkasjidh	njåam^ka^sjidh
njåamkesjidh	njåam^ke^sjidh
njåamoehtidh	njåa^moeh^tidh
njåaptjestidh	njåap^tjes^tidh
njåaptsoestidh	njåap^tsoes^tidh
njåarahtidh	njåa^rah^tidh
njåarenidh	njåa^re^nidh
njåaroehtidh	njåa^roeh^tidh
njåasjlagidh	njåasj^la^gidh
njåatjoedidh	njåa^tjoe^didh
njåatsahtidh	njåa^tsah^tidh
njåatsastidh	njåa^tsas^tidh
njåatsestidh	njåa^tses^tidh
njåatskelidh	njåats^ke^lidh
njåatsoehtidh	njåa^tsoeh^tidh
njåatsoestidh	njåa^tsoes^tidh
njåavvaridh	njåav^va^ridh
njåetsiehtidh	njåe^tsieh^tidh
njåetsiestidh	njåe^tsies^tidh
njåhkasjidh	njåh^ka^sjidh
njåmkehtidh	njåm^keh^tidh
njåmkelidh	njåm^ke^lidh
njårkoehtidh	njår^koeh^tidh
njåållesidh	njåål^le^sidh
njåålmedidh	njåål^me^didh
njååmedidh	njåå^me^didh
njåånestidh	njåå^nes^tidh
njæskoestidh	njæs^koes^tidh
njæssoedidh	njæs^soe^didh
njævhkehtidh	njævh^keh^tidh
njævkesjidh	njæv^ke^sjidh
njïdtjeldidh	njïd^tjel^didh
njïegkestidh	njïeg^kes^tidh
njïehkedidh	njïeh^ke^didh
njïehkesjidh	njïeh^ke^sjidh
njïejestidh	njïe^jes^tidh
njïejkedidh	njïej^ke^didh
njïejkelidh	njïej^ke^lidh
njïekedidh	njïe^ke^didh
njïelkedidh	njïel^ke^didh
njïevehtidh	njïe^veh^tidh
njïevhkehtidh	njïevh^keh^tidh
njïevhkerdidh	njïevh^ker^didh
njïevkerdidh	njïev^ker^didh
njïevkesidh	njïev^ke^sidh
njïevtesjidh	njïev^te^sjidh
njïhkehtidh	njïh^keh^tidh
njïhkesjidh	njïh^ke^sjidh
njïhkestidh	njïh^kes^tidh
njïjhkedidh	njïjh^ke^didh
njïjhkegidh	njïjh^ke^gidh
njïjhkehtidh	njïjh^keh^tidh
njïjhkelidh	njïjh^ke^lidh
njïssedidh	njïs^se^didh
njööllehtidh	njööl^leh^tidh
njöölvestidh	njööl^ves^tidh
njöömehtidh	njöö^meh^tidh
njöömestidh	njöö^mes^tidh
njöömkehtidh	njööm^keh^tidh
njöönehtidh	njöö^neh^tidh
njööredidh	njöö^re^didh
njöörkestidh	njöör^kes^tidh
noddesjidh	nod^de^sjidh
noeledidh	noe^le^didh
noelehtidh	noe^leh^tidh
noelestidh	noe^les^tidh
noerhteldidh	noerh^tel^didh
noeverdidh	noe^ver^didh
noffehtidh	nof^feh^tidh
noffeldidh	nof^fel^didh
nofferdidh	nof^fer^didh
nogkesjidh	nog^ke^sjidh
nohhesjidh	noh^he^sjidh
nohkelidh	noh^ke^lidh
nojjedidh	noj^je^didh
noktjesidh	nok^tje^sidh
noktsesidh	nok^tse^sidh
nolhpesjidh	nolh^pe^sjidh
noljedidh	no^lje^didh
noljestidh	no^ljes^tidh
nollehtidh	nol^leh^tidh
nollelidh	nol^le^lidh
nollenidh	nol^le^nidh
nommehtidh	nom^meh^tidh
nopkelidh	nop^ke^lidh
norhkehtidh	norh^keh^tidh
norresjidh	nor^re^sjidh
nosserdidh	nos^ser^didh
nosseridh	nos^se^ridh
notjkesidh	notj^ke^sidh
novhresjidh	novh^re^sjidh
novpeldidh	nov^pel^didh
nuakasjidh	nua^ka^sjidh
nubpiestidh	nub^pies^tidh
nuegkiehtidh	nueg^kieh^tidh
nujkiestidh	nuj^kies^tidh
nuljedidh	nu^lje^didh
nuljestidh	nu^ljes^tidh
nulliehtidh	nul^lieh^tidh
nullierdidh	nul^lier^didh
nuskehtidh	nus^keh^tidh
nydtehtidh	nyd^teh^tidh
nyjhkesjidh	nyjh^ke^sjidh
nymmehtidh	nym^meh^tidh
nyölkijidh	nyöl^ki^jidh
nyöstedidh	nyös^te^didh
nåagkoedidh	nåag^koe^didh
nåalehtidh	nåa^leh^tidh
nåantehtidh	nåan^teh^tidh
nåarastidh	nåa^ras^tidh
nåelkiedidh	nåel^kie^didh
nåerhtjiehtidh	nåerht^jieh^tidh
nåffadidh	nåf^fa^didh
nåffoehtidh	nåf^foeh^tidh
nåhhadidh	nåh^ha^didh
nåhkedidh	nåh^ke^didh
nåhkehtidh	nåh^keh^tidh
nåhkelidh	nåh^ke^lidh
nåhtadidh	nåh^ta^didh
nåhtasjidh	nåh^ta^sjidh
nåhtjadidh	nåh^tja^didh
nåljoestidh	nå^ljoes^tidh
nållaskidh	nål^las^kidh
nålleskidh	nål^les^kidh
nåvhkehtidh	nåvh^keh^tidh
nåvtedidh	nåv^te^didh
nååhtedidh	nååh^te^didh
nååjsehtidh	nååj^seh^tidh
nåålesidh	nåå^le^sidh
nåålkesidh	nåål^ke^sidh
nåålkesjidh	nåål^ke^sjidh
nååntehtidh	nåån^teh^tidh
næjladidh	næj^la^didh
nænnoedidh	næn^noe^didh
nænnoestidh	næn^noes^tidh
nærradidh	nær^ra^didh
næskoehtidh	næs^koeh^tidh
nïddedidh	nïd^de^didh
nïegkestidh	nïeg^kes^tidh
nïehkesjidh	nïeh^ke^sjidh
nïekedidh	nïe^ke^didh
nïelegidh	nïe^le^gidh
nïerhkelidh	nïerh^ke^lidh
nïestesjidh	nïes^te^sjidh
nïhpesjidh	nïh^pe^sjidh
nïrredidh	nïr^re^didh
nïrrehtidh	nïr^reh^tidh
nïrreridh	nïr^re^ridh
obrestidh	ob^res^tidh
obrijidh	ob^ri^jidh
oddestidh	od^des^tidh
ohtjemidh	oh^tje^midh
ohtsedidh	oh^tse^didh
ohtseldidh	oh^tsel^didh
ohtselidh	oh^tse^lidh
ojkesidh	oj^ke^sidh
ojkesjidh	oj^ke^sjidh
ollestidh	ol^les^tidh
onterdidh	on^ter^didh
opmedidh	op^me^didh
opmeridh	op^me^ridh
orpestidh	or^pes^tidh
orredidh	or^re^didh
orrestidh	or^res^tidh
orrijidh	or^ri^jidh
orrijidh	or^ri^jidh
ossjelidh	os^sje^lidh
ostedidh	os^te^didh
osteridh	os^te^ridh
otnelidh	ot^ne^lidh
ovredidh	ov^re^didh
paahkanidh	paah^ka^nidh
paajsanidh	paaj^sa^nidh
paakadidh	paa^ka^didh
paakedidh	paa^ke^didh
paanhtjedidh	paanht^je^didh
paanhtjehtidh	paanht^jeh^tidh
paasenidh	paa^se^nidh
paentjiehtidh	paen^tjieh^tidh
paffanidh	paf^fa^nidh
pjovvestidh	pjov^ves^tidh
plaahkasjidh	plaah^ka^sjidh
plaakenidh	plaa^ke^nidh
plaavedidh	plaa^ve^didh
plaktesjidh	plak^te^sjidh
plarhkestidh	plarh^kes^tidh
pleajhkasjidh	pleajh^ka^sjidh
pleakadidh	plea^ka^didh
pleaksjasjidh	pleak^sja^sjidh
pleatnjasjidh	pleat^nja^sjidh
pleehkedidh	pleeh^ke^didh
pleejhkestidh	pleejh^kes^tidh
plerhkiedidh	plerh^kie^didh
plidtiehtidh	plid^tieh^tidh
pliejhkiestidh	pliejh^kies^tidh
plienjiehtidh	plie^njieh^tidh
plirkestidh	plir^kes^tidh
plirkiehtidh	plir^kieh^tidh
plisterdidh	plis^ter^didh
ploehtesjidh	ploeh^te^sjidh
plogkedidh	plog^ke^didh
plogkegidh	plog^ke^gidh
plonterdidh	plon^ter^didh
plopkesjidh	plop^ke^sjidh
plotnesjidh	plot^ne^sjidh
pluvhtelidh	pluvh^te^lidh
pluvhtestidh	pluvh^tes^tidh
plyjkestidh	plyj^kes^tidh
plyöjhkedidh	plyöjh^ke^didh
plyöjkesjidh	plyöj^ke^sjidh
plyöjkestidh	plyöj^kes^tidh
plåavehtidh	plåa^veh^tidh
plåavhkesidh	plåavh^ke^sidh
plåavhkestidh	plåavh^kes^tidh
plåavhkestidh	plåavh^kes^tidh
plåehkiehtidh	plåeh^kieh^tidh
plåevhkiehtidh	plåevh^kieh^tidh
plååskesidh	plåås^ke^sidh
plååvedidh	plåå^ve^didh
plædtoehtidh	plæd^toeh^tidh
plïehkegidh	plïeh^ke^gidh
plïehtjehtidh	plïeh^tjeh^tidh
plïejegidh	plïe^je^gidh
plïejhkegidh	plïejh^ke^gidh
plïejhkesjidh	plïejh^ke^sjidh
plïeksjegidh	plïek^sje^gidh
plïjhtjestidh	plïjht^jes^tidh
plïksjegidh	plïk^sje^gidh
povsenidh	pov^se^nidh
praadtesjidh	praad^te^sjidh
praadtjesjidh	praad^tje^sjidh
praahkadidh	praah^ka^didh
praahkasidh	praah^ka^sidh
praahkastidh	praah^kas^tidh
pradtjoestidh	prad^tjoes^tidh
praedtiestidh	praed^ties^tidh
praehkiedidh	praeh^kie^didh
praepkiehtidh	praep^kieh^tidh
pragkedidh	prag^ke^didh
pragkegidh	prag^ke^gidh
prantjegidh	pran^tje^gidh
pratjkoestidh	pratj^koes^tidh
preanghkanidh	preangh^ka^nidh
preejrestidh	preej^res^tidh
preeknedidh	preek^ne^didh
pregkiehtidh	preg^kieh^tidh
prierkiehtidh	prier^kieh^tidh
priesehtidh	prie^seh^tidh
priesiehtidh	prie^sieh^tidh
prihtjiedidh	prih^tjie^didh
prijrestidh	prij^res^tidh
prirkiehtidh	prir^kieh^tidh
provnedidh	prov^ne^didh
provnenidh	prov^ne^nidh
provrenidh	prov^re^nidh
provvenidh	prov^ve^nidh
pruskiehtidh	prus^kieh^tidh
pruvnieldidh	pruv^niel^didh
pruvrehtidh	pruv^reh^tidh
pruvvelidh	pruv^ve^lidh
pryöjjadidh	pryöj^ja^didh
pråaktjelidh	pråak^tje^lidh
pråatjkelidh	pråatj^ke^lidh
pråavoestidh	pråa^voes^tidh
pråektjiestidh	pråek^tjies^tidh
pråetjkiestidh	pråetj^kies^tidh
prååredidh	pråå^re^didh
prægkoestidh	præg^koes^tidh
præjjadidh	præj^ja^didh
prïehtesjidh	prïeh^te^sjidh
prïehtsegidh	prïeh^tse^gidh
prïenghkegidh	prïengh^ke^gidh
prïesehtidh	prïe^seh^tidh
pårjegidh	pår^je^gidh
pårjesjidh	pår^je^sjidh
pïsvesjidh	pïs^ve^sjidh
pïsvestidh	pïs^ves^tidh
raabnesidh	raab^ne^sidh
raagkanidh	raag^ka^nidh
raagkasjidh	raag^ka^sjidh
raagkegidh	raag^ke^gidh
raagkesjidh	raag^ke^sjidh
raahkeldidh	raah^kel^didh
raahkoestidh	raah^koes^tidh
raajedidh	raa^je^didh
raajkamidh	raaj^ka^midh
raajkanidh	raaj^ka^nidh
raajresjidh	raaj^re^sjidh
raakenidh	raa^ke^nidh
raakngesjidh	raak^nge^sjidh
raampeldidh	raam^pel^didh
raarhkehtjidh	raarh^keh^tjidh
raassendidh	raas^sen^didh
raassenidh	raas^se^nidh
raaveldidh	raa^vel^didh
rabkelidh	rab^ke^lidh
rabnjelidh	rab^nje^lidh
rabnjestidh	rab^njes^tidh
radtjoestidh	rad^tjoes^tidh
radtsasjidh	rad^tsa^sjidh
radtsegidh	rad^tse^gidh
raediestidh	rae^dies^tidh
raejkiedidh	raej^kie^didh
raejkiemdidh	raej^kiem^didh
raeriestidh	rae^ries^tidh
rahkestidh	rah^kes^tidh
rahtjastidh	rah^tjas^tidh
rajhnestidh	rajh^nes^tidh
rajjadidh	raj^ja^didh
ramhkoehtidh	ramh^koeh^tidh
ramkelidh	ram^ke^lidh
ramkoehtidh	ram^koeh^tidh
ramkoestidh	ram^koes^tidh
ranjkehtidh	ranj^keh^tidh
rantestidh	ran^tes^tidh
rapkelidh	rap^ke^lidh
rapkestidh	rap^kes^tidh
raskadidh	ras^ka^didh
raskedidh	ras^ke^didh
raskehtidh	ras^keh^tidh
raskoehtidh	ras^koeh^tidh
rastamdidh	ras^tam^didh
rastanidh	ras^ta^nidh
ratnestidh	rat^nes^tidh
ravkedidh	rav^ke^didh
reajdesjidh	reaj^de^sjidh
reakadidh	rea^ka^didh
reakasidh	rea^ka^sidh
reakastidh	rea^kas^tidh
reanesjidh	rea^ne^sjidh
reantesjidh	rean^te^sjidh
reapanidh	rea^pa^nidh
reapsadidh	reap^sa^didh
reapsanidh	reap^sa^nidh
reapsasjidh	reap^sa^sjidh
reavkesidh	reav^ke^sidh
reavkoehtidh	reav^koeh^tidh
rebpieldidh	reb^piel^didh
redtsiedidh	red^tsie^didh
reegkehtidh	reeg^keh^tidh
reegkestidh	reeg^kes^tidh
reehkestidh	reeh^kes^tidh
reehpehtidh	reeh^peh^tidh
reejrehtidh	reej^reh^tidh
reektedidh	reek^te^didh
reektehtidh	reek^teh^tidh
reektestidh	reek^tes^tidh
reessehtidh	rees^seh^tidh
reevhkestidh	reevh^kes^tidh
rehkierdidh	reh^kier^didh
rehkiestidh	reh^kies^tidh
repkiehtidh	rep^kieh^tidh
repkiestidh	rep^kies^tidh
repsiehtidh	rep^sieh^tidh
restiedidh	res^tie^didh
restiemdidh	res^tiem^didh
ribnjestidh	rib^njes^tidh
riegkiedidh	rieg^kie^didh
riegkiegidh	rieg^kie^gidh
riektiedidh	riek^tie^didh
riektiemdidh	riek^tiem^didh
rievkiestidh	riev^kies^tidh
rirviehtidh	rir^vieh^tidh
risjnestidh	risj^nes^tidh
risnjestidh	ris^njes^tidh
ristesidh	ris^te^sidh
roehtestidh	roeh^tes^tidh
roehtsestidh	roeh^tses^tidh
roejestidh	roe^jes^tidh
roengesjidh	roe^nge^sjidh
roepedidh	roe^pe^didh
roepestidh	roe^pes^tidh
roetskehtidh	roets^keh^tidh
roetskesjidh	roets^ke^sjidh
roetskestidh	roets^kes^tidh
roevenidh	roe^ve^nidh
roevhkestidh	roevh^kes^tidh
rohkelidh	roh^ke^lidh
rohpesidh	roh^pe^sidh
rohpestidh	roh^pes^tidh
rohtjeldidh	roh^tjel^didh
rokkestidh	rok^kes^tidh
rokkestidh	rok^kes^tidh
rongkehtidh	rong^keh^tidh
rontestidh	ron^tes^tidh
rotjkedidh	rotj^ke^didh
rotjkesjidh	rotj^ke^sjidh
rovhtestidh	rovh^tes^tidh
rovnedidh	rov^ne^didh
rovrestidh	rov^res^tidh
rovtestidh	rov^tes^tidh
ruapsadidh	ruap^sa^didh
ruapsasjidh	ruap^sa^sjidh
ruarmadidh	ruar^ma^didh
ruehkiehtidh	rueh^kieh^tidh
ruehkiestidh	rueh^kies^tidh
ruejkiestidh	ruej^kies^tidh
ruengiestidh	rue^ngies^tidh
ruetskiehtidh	ruets^kieh^tidh
ruhtjehtidh	ruh^tjeh^tidh
runhtjehtidh	runht^jeh^tidh
runhtjieldidh	runht^jiel^didh
rurhkiehtidh	rurh^kieh^tidh
ryhpesidh	ryh^pe^sidh
ryjhtedidh	ryjh^te^didh
ryjhtestidh	ryjh^tes^tidh
ryjvesjidh	ryj^ve^sjidh
ryjvestidh	ryj^ves^tidh
rypmelidh	ryp^me^lidh
ryöjnesjidh	ryöj^ne^sjidh
ryöjredidh	ryöj^re^didh
ryöjrehtidh	ryöj^reh^tidh
ryökestidh	ryö^kes^tidh
ryöknehtidh	ryök^neh^tidh
ryövhkestidh	ryövh^kes^tidh
råadtsedidh	råad^tse^didh
råahtasjidh	råah^ta^sjidh
råajhnestidh	råajh^nes^tidh
råajoedidh	råa^joe^didh
råajvaridh	råaj^va^ridh
råakedidh	råa^ke^didh
råakoehtidh	råa^koeh^tidh
råamadidh	råa^ma^didh
råamaridh	råa^ma^ridh
råamedidh	råa^me^didh
råangasidh	råa^nga^sidh
råasahtidh	råa^sah^tidh
råasoehtidh	råa^soeh^tidh
råatjnegidh	råatj^ne^gidh
råatnjegidh	råat^nje^gidh
råavehtidh	råa^veh^tidh
råavhnjasjidh	råavh^nja^sjidh
råavhtsasjidh	råavht^sa^sjidh
råavkedidh	råav^ke^didh
råavkestidh	råav^kes^tidh
råavsasjidh	råav^sa^sjidh
råavtjasjidh	råav^tja^sjidh
råavtsasjidh	råav^tsa^sjidh
råedtsedidh	råed^tse^didh
råedtsiedidh	råed^tsie^didh
råeskiehtidh	råes^kieh^tidh
råffasjidh	råf^fa^sjidh
råvnasjidh	råv^na^sjidh
råvnesjidh	råv^ne^sjidh
råådtjesjidh	rååd^tje^sjidh
råådtsegidh	rååd^tse^gidh
råågkesidh	rååg^ke^sidh
rååhkesjidh	rååh^ke^sjidh
rååjhkesjidh	rååjh^ke^sjidh
rååjnesjidh	rååj^ne^sjidh
rååjvedidh	rååj^ve^didh
rååjverdidh	rååj^ver^didh
rååjveridh	rååj^ve^ridh
rååkedidh	råå^ke^didh
rååntjesjidh	råån^tje^sjidh
rååpsedidh	rååp^se^didh
rååresjidh	råå^re^sjidh
råårhkedidh	råårh^ke^didh
råårhkestidh	råårh^kes^tidh
rærroestidh	rær^roes^tidh
rïddesjidh	rïd^de^sjidh
rïddestidh	rïd^des^tidh
rïdtjesjidh	rïd^tje^sjidh
rïehkenidh	rïeh^ke^nidh
rïehpestidh	rïeh^pes^tidh
rïekenidh	rïe^ke^nidh
rïeresjidh	rïe^re^sjidh
rïervestidh	rïer^ves^tidh
rïetjedidh	rïe^tje^didh
rïevhkestidh	rïevh^kes^tidh
rïevnestidh	rïev^nes^tidh
rïgkesjidh	rïg^ke^sjidh
rïhkijidh	rïh^ki^jidh
rïhpesidh	rïh^pe^sidh
rïhpestidh	rïh^pes^tidh
rïhtesidh	rïh^te^sidh
rïjhtestidh	rïjh^tes^tidh
rïjtedidh	rïj^te^didh
rïjtelidh	rïj^te^lidh
rïjvestidh	rïj^ves^tidh
rïpmelidh	rïp^me^lidh
rïrresjidh	rïr^re^sjidh
rïrrestidh	rïr^res^tidh
rïssedidh	rïs^se^didh
rïtnestidh	rït^nes^tidh
röötskelidh	rööts^ke^lidh
röövhkestidh	röövh^kes^tidh
röövhnjehtidh	röövh^njeh^tidh
saadtesidh	saad^te^sidh
saadtesjidh	saad^te^sjidh
saahtesjidh	saah^te^sjidh
saajenidh	saa^je^nidh
saajkardidh	saaj^kar^didh
saajpedidh	saaj^pe^didh
saajrasjidh	saaj^ra^sjidh
saajrenidh	saaj^re^nidh
saajroedidh	saaj^roe^didh
saajroehtidh	saaj^roeh^tidh
saajvestidh	saaj^ves^tidh
saakestidh	saa^kes^tidh
saalestidh	saa^les^tidh
saangerdidh	saa^nger^didh
saarkoehtidh	saar^koeh^tidh
saarnahtidh	saar^nah^tidh
saarnoehtidh	saar^noeh^tidh
saaseridh	saa^se^ridh
sabjasjidh	sab^ja^sjidh
sadtadidh	sad^ta^didh
sadtaridh	sad^ta^ridh
saehtielidh	saeh^tie^lidh
saejhtiedidh	saejh^tie^didh
saejniedidh	saej^nie^didh
saejriedidh	saej^rie^didh
saejrieridh	saej^rie^ridh
saeksiedidh	saek^sie^didh
saemiestidh	sae^mies^tidh
saenjierdidh	sae^njier^didh
saeriehtidh	sae^rieh^tidh
saerniedidh	saer^nie^didh
saerniestidh	saer^nies^tidh
saeviehtidh	sae^vieh^tidh
salhkoehtidh	salh^koeh^tidh
salkehtidh	sal^keh^tidh
salkestidh	sal^kes^tidh
salpelidh	sal^pe^lidh
salpestidh	sal^pes^tidh
sampeldidh	sam^pel^didh
sarhkehtidh	sarh^keh^tidh
sarhkelidh	sarh^ke^lidh
sarhkelidh	sarh^ke^lidh
sarhkesjidh	sarh^ke^sjidh
sarhpehtidh	sarh^peh^tidh
sarhvegidh	sarh^ve^gidh
sarvestidh	sar^ves^tidh
satskehtidh	sats^keh^tidh
savmahtidh	sav^mah^tidh
savraridh	sav^ra^ridh
savsesjidh	sav^se^sjidh
savtalidh	sav^ta^lidh
savvestidh	sav^ves^tidh
seadtjaridh	sead^tja^ridh
seadtoedidh	sead^toe^didh
seadtoehtidh	sead^toeh^tidh
seagkanidh	seag^ka^nidh
seahkaridh	seah^ka^ridh
seajsasjidh	seaj^sa^sjidh
seakestidh	sea^kes^tidh
seaknadidh	seak^na^didh
seakngadidh	seak^nga^didh
sealadidh	sea^la^didh
sealjanidh	sea^lja^nidh
seamadidh	sea^ma^didh
searanidh	sea^ra^nidh
searkasidh	sear^ka^sidh
searrasjidh	sear^ra^sjidh
seatadidh	sea^ta^didh
seavahtidh	sea^vah^tidh
seavoehtidh	sea^voeh^tidh
seedtestidh	seed^tes^tidh
seejkedidh	seej^ke^didh
seejkesidh	seej^ke^sidh
seejkestidh	seej^kes^tidh
seerehtidh	see^reh^tidh
seerkestidh	seer^kes^tidh
seerredidh	seer^re^didh
seerrestidh	seer^res^tidh
seevehtidh	see^veh^tidh
sehpieldidh	seh^piel^didh
sehtiehtidh	seh^tieh^tidh
selsiedidh	sel^sie^didh
semkiehtidh	sem^kieh^tidh
semkiestidh	sem^kies^tidh
sepkielidh	sep^kie^lidh
sepkiestidh	sep^kies^tidh
serhkielidh	serh^kie^lidh
serhkiestidh	serh^kies^tidh
serkiestidh	ser^kies^tidh
sertiestidh	ser^ties^tidh
siegkiedidh	sieg^kie^didh
siegkiedidh	sieg^kie^didh
siegkiehtidh	sieg^kieh^tidh
siekierdidh	sie^kier^didh
sieljiehtidh	sie^ljieh^tidh
sienedidh	sie^ne^didh
siengieldidh	sie^ngiel^didh
sieniedidh	sie^nie^didh
sierngiedidh	sier^ngie^didh
sierngieldidh	sier^ngiel^didh
sietiedidh	sie^tie^didh
sieviehtidh	sie^vieh^tidh
sievielidh	sie^vie^lidh
sigkestidh	sig^kes^tidh
sihkeldidh	sih^kel^didh
sihkieldidh	sih^kiel^didh
sijjiestidh	sij^jies^tidh
sikngeridh	sik^nge^ridh
siknjedidh	sik^nje^didh
siknjiedidh	sik^njie^didh
singkeldidh	sing^kel^didh
sinnjeldidh	sin^njel^didh
sirrieldidh	sir^riel^didh
sitnjedidh	sit^nje^didh
sjaajhkehtidh	sjaajh^keh^tidh
sjaamestidh	sjaa^mes^tidh
sjaavnjoehtidh	sjaav^njoeh^tidh
sjaejmoejidh	sjaej^moe^jidh
sjaepiehtidh	sjae^pieh^tidh
sjaepielidh	sjae^pie^lidh
sjalkelidh	sjal^ke^lidh
sjalkeridh	sjal^ke^ridh
sjallaridh	sjal^la^ridh
sjalmehtidh	sjal^meh^tidh
sjammadidh	sjam^ma^didh
sjammehtidh	sjam^meh^tidh
sjamparidh	sjam^pa^ridh
sjannjeldidh	sjan^njel^didh
sjavhkadidh	sjavh^ka^didh
sjeagkamidh	sjeag^ka^midh
sjeajvelidh	sjeaj^ve^lidh
sjealadidh	sjea^la^didh
sjeepedidh	sjee^pe^didh
sjeevehtidh	sjee^veh^tidh
sjegkiehtidh	sjeg^kieh^tidh
sjelhkiedidh	sjelh^kie^didh
sjelhkiestidh	sjelh^kies^tidh
sjelkiehtidh	sjel^kieh^tidh
sjelkiehtidh	sjel^kieh^tidh
sjelmiehtidh	sjel^mieh^tidh
sjelsjiedidh	sjel^sjie^didh
sjetnierdidh	sjet^nier^didh
sjiepkieldidh	sjiep^kiel^didh
sjieriemdidh	sjie^riem^didh
sjijsjelidh	sjij^sje^lidh
sjilkehtidh	sjil^keh^tidh
sjilkehtidh	sjil^keh^tidh
sjilkestidh	sjil^kes^tidh
sjinnjeldidh	sjin^njel^didh
sjivnedidh	sjiv^ne^didh
sjnåehriestidh	sjnåeh^ries^tidh
sjodkesjidh	sjod^ke^sjidh
sjoehkedidh	sjoeh^ke^didh
sjoehkehtidh	sjoeh^keh^tidh
sjoehkesjidh	sjoeh^ke^sjidh
sjoeksjehtidh	sjoek^sjeh^tidh
sjoeledidh	sjoe^le^didh
sjoevelidh	sjoe^ve^lidh
sjogkelidh	sjog^ke^lidh
sjohlestidh	sjoh^les^tidh
sjollehtidh	sjol^leh^tidh
sjovhlestidh	sjovh^les^tidh
sjovnestidh	sjov^nes^tidh
sjuavnjadidh	sjuav^nja^didh
sjubrestidh	sjub^res^tidh
sjuehkiehtidh	sjueh^kieh^tidh
sjuesjiedidh	sjue^sjie^didh
sjuesjiehtidh	sjue^sjieh^tidh
sjuevkiehtidh	sjuev^kieh^tidh
sjuevnjiedidh	sjuev^njie^didh
sjugkiehtidh	sjug^kieh^tidh
sjugniedidh	sjug^nie^didh
sjurhpiedidh	sjurh^pie^didh
sjurhpiestidh	sjurh^pies^tidh
sjurkiehtidh	sjur^kieh^tidh
sjyjjedidh	sjyj^je^didh
sjyjjegidh	sjyj^je^gidh
sjyjjesjidh	sjyj^je^sjidh
sjyjsjelidh	sjyj^sje^lidh
sjyöhtesjidh	sjyöh^te^sjidh
sjyöjkedidh	sjyöj^ke^didh
sjyöjkesidh	sjyöj^ke^sidh
sjåaredidh	sjåa^re^didh
sjåaroehtidh	sjåa^roeh^tidh
sjåavahtidh	sjåa^vah^tidh
sjåavkelidh	sjåav^ke^lidh
sjåavoehtidh	sjåa^voeh^tidh
sjåhtedidh	sjåh^te^didh
sjårhpadidh	sjårh^pa^didh
sjååjkesidh	sjååj^ke^sidh
sjååvedidh	sjåå^ve^didh
sjæjsjalidh	sjæj^sja^lidh
sjïbbedidh	sjïb^be^didh
sjïdtedidh	sjïd^te^didh
sjïdtehtidh	sjïd^teh^tidh
sjïdtelidh	sjïd^te^lidh
sjïdteridh	sjïd^te^ridh
sjïdtestidh	sjïd^tes^tidh
sjïehtedidh	sjïeh^te^didh
sjïehtehtidh	sjïeh^teh^tidh
sjïehtesjidh	sjïeh^te^sjidh
sjïekedidh	sjïe^ke^didh
sjïekesjidh	sjïe^ke^sjidh
sjïekestidh	sjïe^kes^tidh
sjïeledidh	sjïe^le^didh
sjïeleridh	sjïe^le^ridh
sjöövehtidh	sjöö^veh^tidh
sjöövelidh	sjöö^ve^lidh
skaadtjerdidh	skaad^tjer^didh
skaahkanidh	skaah^ka^nidh
skaajveldidh	skaaj^vel^didh
skaalterdidh	skaal^ter^didh
skaamasidh	skaa^ma^sidh
skaamasjidh	skaa^ma^sjidh
skaamesjidh	skaa^me^sjidh
skaanhtedidh	skaanh^te^didh
skaaroehtidh	skaa^roeh^tidh
skaavestidh	skaa^ves^tidh
skaejvieldidh	skaej^viel^didh
skaenjieldidh	skae^njiel^didh
skaepiedidh	skae^pie^didh
skaepiedidh	skae^pie^didh
skahtjanidh	skah^tja^nidh
skajkelidh	skaj^ke^lidh
skalkelidh	skal^ke^lidh
skamhkahtidh	skamh^kah^tidh
skamhkelidh	skamh^ke^lidh
skamhkoehtidh	skamh^koeh^tidh
skarrehtidh	skar^reh^tidh
skarreldidh	skar^rel^didh
skavlastidh	skav^las^tidh
skeagkoerdidh	skeag^koer^didh
skeajesidh	skea^je^sidh
skeajmestidh	skeaj^mes^tidh
skeajtardidh	skeaj^tar^didh
skealparidh	skeal^pa^ridh
skeammanidh	skeam^ma^nidh
skearkagidh	skear^ka^gidh
skearmanidh	skear^ma^nidh
skeekedidh	skee^ke^didh
skeerelidh	skee^re^lidh
skeerestidh	skee^res^tidh
skeerhtestidh	skeerh^tes^tidh
skeerjestidh	skeer^jes^tidh
skejkiehtidh	skej^kieh^tidh
skentjieldidh	sken^tjiel^didh
skerhkiehtidh	skerh^kieh^tidh
skerriehtidh	sker^rieh^tidh
skiblesjidh	skib^le^sjidh
skiejterdidh	skiej^ter^didh
skiejtierdidh	skiej^tier^didh
skielkiehtidh	skiel^kieh^tidh
skielpiestidh	skiel^pies^tidh
skierhpiedidh	skierh^pie^didh
skierkiehtidh	skier^kieh^tidh
skilhtjegidh	skilht^je^gidh
skilhtjiehtidh	skilht^jieh^tidh
skintestidh	skin^tes^tidh
skirmieldidh	skir^miel^didh
skitjkiestidh	skitj^kies^tidh
skitjskiestidh	skitjs^kies^tidh
skobtjeldidh	skob^tjel^didh
skodtedidh	skod^te^didh
skodtehtidh	skod^teh^tidh
skoehtestidh	skoeh^tes^tidh
skoejedidh	skoe^je^didh
skoelestidh	skoe^les^tidh
skoelkelidh	skoel^ke^lidh
skoelledidh	skoel^le^didh
skoellegidh	skoel^le^gidh
skoellerdidh	skoel^ler^didh
skoelterdidh	skoel^ter^didh
skoepenidh	skoe^pe^nidh
skoerehtidh	skoe^reh^tidh
skoerkedidh	skoer^ke^didh
skoerkestidh	skoer^kes^tidh
skoevesjidh	skoe^ve^sjidh
skohteldidh	skoh^tel^didh
skohtestidh	skoh^tes^tidh
skojjesjidh	skoj^je^sjidh
skolnjegidh	skol^nje^gidh
skompeldidh	skom^pel^didh
skomtjeldidh	skom^tjel^didh
skonhkelidh	skonh^ke^lidh
skorkelidh	skor^ke^lidh
skorkestidh	skor^kes^tidh
skorpedidh	skor^pe^didh
skorpelidh	skor^pe^lidh
skovhtestidh	skovh^tes^tidh
skovrestidh	skov^res^tidh
skraampeldidh	skraam^pel^didh
skraejriehtidh	skraej^rieh^tidh
skraevviestidh	skraev^vies^tidh
skrakladidh	skra^kla^didh
skreedkelidh	skreed^ke^lidh
skreedkestidh	skreed^kes^tidh
skreejrehtidh	skreej^reh^tidh
skreepestidh	skree^pes^tidh
skreerkelidh	skreer^ke^lidh
skreerkestidh	skreer^kes^tidh
skrehkiestidh	skreh^kies^tidh
skrodtjegidh	skrod^tje^gidh
skromhkelidh	skromh^ke^lidh
skronhtjegidh	skronht^je^gidh
skrovhpesjidh	skrovh^pe^sjidh
skrumhkiestidh	skrumh^kies^tidh
skråadtjegidh	skråad^tje^gidh
skråahkegidh	skråah^ke^gidh
skråahroestidh	skråah^roes^tidh
skråepiedidh	skråe^pie^didh
skråevviestidh	skråev^vies^tidh
skrånhtjegidh	skrånht^je^gidh
skrïehpestidh	skrïeh^pes^tidh
skrïepmestidh	skrïep^mes^tidh
skrööntehtidh	skröön^teh^tidh
skröötestidh	skröö^tes^tidh
skuajasjidh	skua^ja^sjidh
skuapmanidh	skuap^ma^nidh
skuarhtjadidh	skuarht^ja^didh
skuekierdidh	skue^kier^didh
skuglehtidh	skug^leh^tidh
skungkerdidh	skung^ker^didh
skungkieldidh	skung^kiel^didh
skupmestidh	skup^mes^tidh
skuptjiestidh	skup^tjies^tidh
skurkiehtidh	skur^kieh^tidh
skurkiehtidh	skur^kieh^tidh
skuvlestidh	skuv^les^tidh
skuvmiestidh	skuv^mies^tidh
skvaallerdidh	skvaal^ler^didh
skvaalterdidh	skvaal^ter^didh
skygkerdidh	skyg^ker^didh
skyhtestidh	skyh^tes^tidh
skylledidh	skyl^le^didh
skyvhtestidh	skyvh^tes^tidh
skyvredidh	skyv^re^didh
skyörestidh	skyö^res^tidh
skåahtadidh	skåah^ta^didh
skåakestidh	skåa^kes^tidh
skåalvasjidh	skåal^va^sjidh
skåangkadidh	skåang^ka^didh
skåebtielidh	skåeb^tie^lidh
skåemtieldidh	skåem^tiel^didh
skåglasjidh	skåg^la^sjidh
skåhtjanidh	skåh^tja^nidh
skångkadidh	skång^ka^didh
skåptjoestidh	skåp^tjoes^tidh
skårhkadidh	skårh^ka^didh
skååjjeldidh	skååj^jel^didh
skåålvesjidh	skåål^ve^sjidh
skægkoerdidh	skæg^koer^didh
skælhtasjidh	skælh^ta^sjidh
skælladidh	skæl^la^didh
skællasjidh	skæl^la^sjidh
skærradidh	skær^ra^didh
skïebtjijidh	skïeb^tji^jidh
skïejrestidh	skïej^res^tidh
skïejvestidh	skïej^ves^tidh
skïelhkehtidh	skïelh^keh^tidh
skïelhkesjidh	skïelh^ke^sjidh
skïelmedidh	skïel^me^didh
skïelpesjidh	skïel^pe^sjidh
skïelpestidh	skïel^pes^tidh
skïemmenidh	skïem^me^nidh
skïemtjeldidh	skïem^tjel^didh
skïemtjijidh	skïem^tji^jidh
skïerkedidh	skïer^ke^didh
skïerkegidh	skïer^ke^gidh
skïhterdidh	skïh^ter^didh
skïjrehtidh	skïj^reh^tidh
skïjrestidh	skïj^res^tidh
skööpmestidh	skööp^mes^tidh
slaadterdidh	slaad^ter^didh
slaahpestidh	slaah^pes^tidh
slaajperdidh	slaaj^per^didh
slaamehtidh	slaa^meh^tidh
slaameridh	slaa^me^ridh
slaamkoedidh	slaam^koe^didh
slaamkoehtidh	slaam^koeh^tidh
slaamperdidh	slaam^per^didh
slaamperstidh	slaam^per^stidh
slaapanidh	slaa^pa^nidh
slaapehtidh	slaa^peh^tidh
slaaptjasjidh	slaap^tja^sjidh
slaaptjegidh	slaap^tje^gidh
slaaptjehtidh	slaap^tjeh^tidh
slaarvestidh	slaar^ves^tidh
slaaterdidh	slaa^ter^didh
slaaverdidh	slaa^ver^didh
slabpanidh	slab^pa^nidh
slabperidh	slab^pe^ridh
slaekierdidh	slae^kier^didh
slaemkiestidh	slaem^kies^tidh
slaepiehtidh	slae^pieh^tidh
slaepkiestidh	slaep^kies^tidh
slaeptjiehtidh	slaep^tjieh^tidh
slaevkiestidh	slaev^kies^tidh
slahtjegidh	slah^tje^gidh
slahtjehtidh	slah^tjeh^tidh
slajkehtidh	slaj^keh^tidh
slajkelidh	slaj^ke^lidh
slajkestidh	slaj^kes^tidh
slajpasjidh	slaj^pa^sjidh
slajpegidh	slaj^pe^gidh
slajvelidh	slaj^ve^lidh
slajvesidh	slaj^ve^sidh
slajvestidh	slaj^ves^tidh
slampestidh	slam^pes^tidh
slapmegidh	slap^me^gidh
slatjkoehtidh	slatj^koeh^tidh
slavhtjedidh	slavht^je^didh
sleabpahtidh	sleab^pah^tidh
sleadtjegidh	slead^tje^gidh
sleagrasjidh	sleag^ra^sjidh
sleahtjegidh	sleah^tje^gidh
sleajhpestidh	sleajh^pes^tidh
sleajhtestidh	sleajh^tes^tidh
sleaptjanidh	sleap^tja^nidh
slearasidh	slea^ra^sidh
slearaskidh	slea^ras^kidh
sleatjadidh	slea^tja^didh
sleatsedidh	slea^tse^didh
slebpiehtidh	sleb^pieh^tidh
sleebpestidh	sleeb^pes^tidh
sleegrehtidh	sleeg^reh^tidh
sleehkestidh	sleeh^kes^tidh
sleevvehtidh	sleev^veh^tidh
slejkiehtidh	slej^kieh^tidh
slessiedidh	sles^sie^didh
slibnjegidh	slib^nje^gidh
slibrehtidh	slib^reh^tidh
slienghkiehtidh	sliengh^kieh^tidh
slienhkiehtidh	slienh^kieh^tidh
sliepkiehtidh	sliep^kieh^tidh
slieriestidh	slie^ries^tidh
slihkesjidh	slih^ke^sjidh
slijhtenidh	slijh^te^nidh
slimkiestidh	slim^kies^tidh
slingkerdidh	sling^ker^didh
slipkehtidh	slip^keh^tidh
slipmegidh	slip^me^gidh
slobpelidh	slob^pe^lidh
slobpesidh	slob^pe^sidh
slobpestidh	slob^pes^tidh
sloeptjegidh	sloep^tje^gidh
slogkesidh	slog^ke^sidh
slognestidh	slog^nes^tidh
slohpesidh	sloh^pe^sidh
slomperdidh	slom^per^didh
slonhterdidh	slonh^ter^didh
slotjkehtidh	slotj^keh^tidh
slovhpedidh	slovh^pe^didh
slovhtjegidh	slovht^je^gidh
slubpiehtidh	slub^pieh^tidh
sluvviestidh	sluv^vies^tidh
slyvkerdidh	slyv^ker^didh
slåahtjegidh	slåah^tje^gidh
slåapkelidh	slåap^ke^lidh
slåaptjoehtidh	slåap^tjoeh^tidh
slåavelidh	slåa^ve^lidh
slåavestidh	slåa^ves^tidh
slågkagidh	slåg^ka^gidh
slååhpesjidh	slååh^pe^sjidh
slååhtjedidh	slååh^tje^didh
slæjhtanidh	slæjh^ta^nidh
slæjraridh	slæj^ra^ridh
slïbnjegidh	slïb^nje^gidh
slïebpesidh	slïeb^pe^sidh
slïedtjegidh	slïed^tje^gidh
slïegresjidh	slïeg^re^sjidh
slïejhpestidh	slïejh^pes^tidh
slïenghkesidh	slïengh^ke^sidh
slïenghkiehtidh	slïengh^kieh^tidh
slïepkelidh	slïep^ke^lidh
slïerjegidh	slïer^je^gidh
slïevkegidh	slïev^ke^gidh
slïmhpedidh	slïmh^pe^didh
slïmpegidh	slïm^pe^gidh
slïmperdidh	slïm^per^didh
slööptjestidh	slööp^tjes^tidh
slöövedidh	slöö^ve^didh
slöövehtidh	slöö^veh^tidh
smaehkiedidh	smaeh^kie^didh
smaeriedidh	smae^rie^didh
smalhtjaridh	smalht^ja^ridh
smallesidh	smal^le^sidh
smaltjaridh	smal^tja^ridh
smarkadidh	smar^ka^didh
smealaridh	smea^la^ridh
smealladidh	smeal^la^didh
smealloehtidh	smeal^loeh^tidh
smealnjahtidh	smeal^njah^tidh
smealnjiedidh	smeal^njie^didh
smeegrehtidh	smeeg^reh^tidh
smeelehtidh	smee^leh^tidh
smielhkiehtidh	smielh^kieh^tidh
smielmiedidh	smiel^mie^didh
smielnjiedidh	smiel^njie^didh
smirnjelidh	smir^nje^lidh
smirtjestidh	smir^tjes^tidh
smuelkiehtidh	smuel^kieh^tidh
smutjkiestidh	smutj^kies^tidh
smuvvielidh	smuv^vie^lidh
smållenidh	smål^le^nidh
smååhkedidh	smååh^ke^didh
smååhkestidh	smååh^kes^tidh
smååkedidh	småå^ke^didh
smïerkesidh	smïer^ke^sidh
snaabrestidh	snaab^res^tidh
snaaktselidh	snaak^tse^lidh
snaaskadidh	snaas^ka^didh
snabpestidh	snab^pes^tidh
snaerpiedidh	snaer^pie^didh
snaglasjidh	snag^la^sjidh
snahkadidh	snah^ka^didh
snahkaridh	snah^ka^ridh
snahkestidh	snah^kes^tidh
snarhpadidh	snarh^pa^didh
snavsahtidh	snav^sah^tidh
sneavlasjidh	sneav^la^sjidh
snihkiestidh	snih^kies^tidh
sniptjehtidh	snip^tjeh^tidh
snjabpestidh	snjab^pes^tidh
snjadtsegidh	snjad^tse^gidh
snjaefiestidh	snjae^fies^tidh
snjahpehtidh	snjah^peh^tidh
snjahtasjidh	snjah^ta^sjidh
snjaltjegidh	snjal^tje^gidh
snjapkelidh	snjap^ke^lidh
snjaptjehtidh	snjap^tjeh^tidh
snjaptjestidh	snjap^tjes^tidh
snjaptsehtidh	snjap^tseh^tidh
snjaptsestidh	snjap^tses^tidh
snjarhtjegidh	snjarht^je^gidh
snjeemkehtidh	snjeem^keh^tidh
snjeemkesidh	snjeem^ke^sidh
snjeeredidh	snjee^re^didh
snjerviestidh	snjer^vies^tidh
snjidtjehtidh	snjid^tjeh^tidh
snjietsiestidh	snjie^tsies^tidh
snjiltjehtidh	snjil^tjeh^tidh
snjipkelidh	snjip^ke^lidh
snjipkestidh	snjip^kes^tidh
snjitjkehtidh	snjitj^keh^tidh
snjitjkestidh	snjitj^kes^tidh
snjoerhtjedidh	snjoerht^je^didh
snjoerhtjegidh	snjoerht^je^gidh
snjollegidh	snjol^le^gidh
snjovtjestidh	snjov^tjes^tidh
snjovvestidh	snjov^ves^tidh
snjugliehtidh	snjug^lieh^tidh
snjuhtjehtidh	snjuh^tjeh^tidh
snjulliehtidh	snjul^lieh^tidh
snjåadastidh	snjåa^das^tidh
snjåajpeldidh	snjåaj^pel^didh
snjåarestidh	snjåa^res^tidh
snjåarkehtidh	snjåar^keh^tidh
snjåarkelidh	snjåar^ke^lidh
snjåehriestidh	snjåeh^ries^tidh
snjåerkiehtidh	snjåer^kieh^tidh
snjålhtasjidh	snjålh^ta^sjidh
snjååjpeldidh	snjååj^pel^didh
snjååpedidh	snjåå^pe^didh
snjæjradidh	snjæj^ra^didh
snjïerkesidh	snjïer^ke^sidh
snjïerpedidh	snjïer^pe^didh
snjïerpehtidh	snjïer^peh^tidh
snjïerpesidh	snjïer^pe^sidh
snjïetjkehtidh	snjïetj^keh^tidh
snjïtjkehtidh	snjïtj^keh^tidh
snjöörkehtidh	snjöör^keh^tidh
snoehtegidh	snoeh^te^gidh
snoelkedidh	snoel^ke^didh
snoelkestidh	snoel^kes^tidh
snohterdidh	snoh^ter^didh
snolhpestidh	snolh^pes^tidh
snolhpestidh	snolh^pes^tidh
snorhpegidh	snorh^pe^gidh
snorhpelidh	snorh^pe^lidh
snorhtjesjidh	snorht^je^sjidh
snorjeldidh	snor^jel^didh
snorkesidh	snor^ke^sidh
snorredidh	snor^re^didh
snotskedidh	snots^ke^didh
snovhtesjidh	snovh^te^sjidh
snovsedidh	snov^se^didh
snovsehtidh	snov^seh^tidh
snuhkiehtidh	snuh^kieh^tidh
snuhkiestidh	snuh^kies^tidh
snuhtierdidh	snuh^tier^didh
snuvrehtidh	snuv^reh^tidh
snåhkaridh	snåh^ka^ridh
snårhpoedidh	snårh^poe^didh
snåvsoehtidh	snåv^soeh^tidh
snæhkadidh	snæh^ka^didh
snæjhkoehtidh	snæjh^koeh^tidh
snïjrestidh	snïj^res^tidh
snïrredidh	snïr^re^didh
snööhtehtidh	snööh^teh^tidh
snöölestidh	snöö^les^tidh
snöörjelidh	snöör^je^lidh
soejelidh	soe^je^lidh
soejjegidh	soej^je^gidh
soejkesjidh	soej^ke^sjidh
soejmenidh	soej^me^nidh
soelkedidh	soel^ke^didh
soelkehtidh	soel^keh^tidh
soelkenidh	soel^ke^nidh
soenenidh	soe^ne^nidh
soepesjidh	soe^pe^sjidh
soersenidh	soer^se^nidh
soeskehtidh	soes^keh^tidh
soetestidh	soe^tes^tidh
soevedidh	soe^ve^didh
soevestidh	soe^ves^tidh
sogkesidh	sog^ke^sidh
sohkesjidh	soh^ke^sjidh
sohpedidh	soh^pe^didh
sohtehtidh	soh^teh^tidh
sojjedidh	soj^je^didh
sojjehtidh	soj^jeh^tidh
sokngehtidh	sok^ngeh^tidh
sommedidh	som^me^didh
soptsestidh	sop^tses^tidh
sorhpehtidh	sorh^peh^tidh
sorhpestidh	sorh^pes^tidh
sorkenidh	sor^ke^nidh
sovhkedidh	sovh^ke^didh
sovhtjegidh	sovht^je^gidh
sovkedidh	sov^ke^didh
sovkehtidh	sov^keh^tidh
sovkelidh	sov^ke^lidh
sovkijidh	sov^ki^jidh
sovmehtidh	sov^meh^tidh
sovnjedidh	sov^nje^didh
sovvehtjidh	sov^veh^tjidh
spaajhkestidh	spaajh^kes^tidh
spaanestidh	spaa^nes^tidh
spaarresjidh	spaar^re^sjidh
spaekiestidh	spae^kies^tidh
speadtjesidh	spead^tje^sidh
speahtjasidh	speah^tja^sidh
speajestidh	spea^jes^tidh
spealadidh	spea^la^didh
spealalidh	spea^la^lidh
spealhkesidh	spealh^ke^sidh
speatjadidh	spea^tja^didh
speedtjestidh	speed^tjes^tidh
speehkestidh	speeh^kes^tidh
speelhkehtidh	speelh^keh^tidh
speelhkestidh	speelh^kes^tidh
speerrelidh	speer^re^lidh
sperniedidh	sper^nie^didh
spiejiestidh	spie^jies^tidh
spijhkierdidh	spijh^kier^didh
spiktjesjidh	spik^tje^sjidh
spraanhtehtidh	spraanh^teh^tidh
spræhkadidh	spræh^ka^didh
sprïjnehtidh	sprïj^neh^tidh
spyölesidh	spyö^le^sidh
spyölhkesidh	spyölh^ke^sidh
spååredidh	spåå^re^didh
spædtjasidh	spæd^tja^sidh
spædtjastidh	spæd^tjas^tidh
spæjngahtidh	spæj^ngah^tidh
spïelhkesidh	spïelh^ke^sidh
spöörnjehtidh	spöör^njeh^tidh
spöövhrehtidh	spöövh^reh^tidh
staahkadidh	staah^ka^didh
staalhpesidh	staalh^pe^sidh
staameldidh	staa^mel^didh
staanadidh	staa^na^didh
staaranidh	staa^ra^nidh
staavadidh	staa^va^didh
staavtjanidh	staav^tja^nidh
staavtjaridh	staav^tja^ridh
stadtjasjidh	stad^tja^sjidh
staentierdidh	staen^tier^didh
staeriedidh	stae^rie^didh
staeriemdidh	stae^riem^didh
stajjadidh	staj^ja^didh
stajkestidh	staj^kes^tidh
stamhpestidh	stamh^pes^tidh
stamkesjidh	stam^ke^sjidh
stantjeldidh	stan^tjel^didh
stealladidh	steal^la^didh
stebpieldidh	steb^piel^didh
steehpehtidh	steeh^peh^tidh
steelhpesidh	steelh^pe^sidh
steellestidh	steel^les^tidh
steeredidh	stee^re^didh
steerestidh	stee^res^tidh
stejjiedidh	stej^jie^didh
stejkiestidh	stej^kies^tidh
sterpiedidh	ster^pie^didh
stihtjiehtidh	stih^tjieh^tidh
stijrestidh	stij^res^tidh
stinkestidh	stin^kes^tidh
stoenehtidh	stoe^neh^tidh
stoevedidh	stoe^ve^didh
stogkestidh	stog^kes^tidh
stohkestidh	stoh^kes^tidh
stolhtjegidh	stolht^je^gidh
stomkesjidh	stom^ke^sjidh
stompeldidh	stom^pel^didh
stompelidh	stom^pe^lidh
stonkehtidh	ston^keh^tidh
straenjiestidh	strae^njies^tidh
strahkestidh	strah^kes^tidh
strajkehtidh	straj^keh^tidh
stratjkehtidh	stratj^keh^tidh
streekadidh	stree^ka^didh
strerkiestidh	strer^kies^tidh
strovhkesjidh	strovh^ke^sjidh
strovkesidh	strov^ke^sidh
struerkiestidh	struer^kies^tidh
strupkiehtidh	strup^kieh^tidh
struvkestidh	struv^kes^tidh
struvkiestidh	struv^kies^tidh
stryjhkesjidh	stryjh^ke^sjidh
strïehpehtidh	strïeh^peh^tidh
strïjhtjehtidh	strïjht^jeh^tidh
strööntehtidh	ströön^teh^tidh
stuarasjidh	stua^ra^sjidh
stueliestidh	stue^lies^tidh
stueriedidh	stue^rie^didh
stueriemdidh	stue^riem^didh
stujmiedidh	stuj^mie^didh
stuvrehtidh	stuv^reh^tidh
stygkerdidh	styg^ker^didh
stygkeridh	styg^ke^ridh
ståaloehtidh	ståa^loeh^tidh
ståangkestidh	ståang^kes^tidh
ståaradidh	ståa^ra^didh
ståavestidh	ståa^ves^tidh
stååkedidh	ståå^ke^didh
stååresjidh	ståå^re^sjidh
stååvtjedidh	stååv^tje^didh
stååvtjerdidh	stååv^tjer^didh
stæhtjasjidh	stæh^tja^sjidh
stæmmadidh	stæm^ma^didh
stïeglesjidh	stïeg^le^sjidh
stïssedidh	stïs^se^didh
stöölestidh	stöö^les^tidh
stöövedidh	stöö^ve^didh
suahpastidh	suah^pas^tidh
suajmamidh	suaj^ma^midh
suajmanidh	suaj^ma^nidh
sualadidh	sua^la^didh
sualasidh	sua^la^sidh
suegkiedidh	sueg^kie^didh
suehpiedidh	sueh^pie^didh
suehpiehtidh	sueh^pieh^tidh
suejielidh	sue^jie^lidh
sueviedidh	sue^vie^didh
suhtiehtidh	suh^tieh^tidh
suvriedidh	suv^rie^didh
suvtiehtidh	suv^tieh^tidh
svaajhpestidh	svaajh^pes^tidh
svaajloehtidh	svaaj^loeh^tidh
svaalnoedidh	svaal^noe^didh
svaaloedidh	svaa^loe^didh
svaanjkestidh	svaanj^kes^tidh
svaatjeldidh	svaa^tjel^didh
svaatjkestidh	svaatj^kes^tidh
svaatjkoestidh	svaatj^koes^tidh
svaejliehtidh	svaej^lieh^tidh
svalkaridh	sval^ka^ridh
svarkeldidh	svar^kel^didh
svarkelidh	svar^ke^lidh
svarresjidh	svar^re^sjidh
svatjkesidh	svatj^ke^sidh
sveadadidh	svea^da^didh
sveedteldidh	sveed^tel^didh
sveehkestidh	sveeh^kes^tidh
sveerkehtidh	sveer^keh^tidh
sveertehtidh	sveer^teh^tidh
sverkiehtidh	sver^kieh^tidh
svijredidh	svij^re^didh
svilkestidh	svil^kes^tidh
svilkiestidh	svil^kies^tidh
svinhtestidh	svinh^tes^tidh
svitjkerdidh	svitj^ker^didh
svitnestidh	svit^nes^tidh
svåjkesidh	svåj^ke^sidh
svåjkesjidh	svåj^ke^sjidh
svååjpeldidh	svååj^pel^didh
svæjmadidh	svæj^ma^didh
svæjmoedidh	svæj^moe^didh
svæktjerdidh	svæk^tjer^didh
svælnganidh	svæl^nga^nidh
svïenskestidh	svïen^skes^tidh
svïhtjestidh	svïh^tjes^tidh
svïktjerdidh	svïk^tjer^didh
svïmtjerdidh	svïm^tjer^didh
svïrhkestidh	svïrh^kes^tidh
svïtjkerdidh	svïtj^ker^didh
sygkeldidh	syg^kel^didh
sygkesidh	syg^ke^sidh
syjhtjegidh	syjht^je^gidh
syjjedidh	syj^je^didh
syjjehtidh	syj^jeh^tidh
syöjkedidh	syöj^ke^didh
syöjkesidh	syöj^ke^sidh
syöjsesjidh	syöj^se^sjidh
såabraridh	såab^ra^ridh
såabregidh	såab^re^gidh
såahpahtidh	såah^pah^tidh
såajjegidh	såaj^je^gidh
såajjoehtidh	såaj^joeh^tidh
såajmanidh	såaj^ma^nidh
såajtalidh	såaj^ta^lidh
såajtoedidh	såaj^toe^didh
såajtoelidh	såaj^toe^lidh
såakaridh	såa^ka^ridh
såakoedidh	såa^koe^didh
såakoehtidh	såa^koeh^tidh
såapadidh	såa^pa^didh
såapoedidh	såa^poe^didh
såarastidh	såa^ras^tidh
såataskidh	såa^tas^kidh
såatjahtidh	såa^tjah^tidh
såatjehtidh	såa^tjeh^tidh
sådtoedidh	såd^toe^didh
såegkiedidh	såeg^kie^didh
såhkadidh	såh^ka^didh
sårjoedidh	sår^joe^didh
sårjoehtidh	sår^joeh^tidh
såvmahtidh	såv^mah^tidh
såvradidh	såv^ra^didh
såvranidh	såv^ra^nidh
såvsasjidh	såv^sa^sjidh
såågkesidh	sååg^ke^sidh
sååjhtestidh	sååjh^tes^tidh
sååjresjidh	sååj^re^sjidh
sååjvelidh	sååj^ve^lidh
sååjvesidh	sååj^ve^sidh
sååkesjidh	såå^ke^sjidh
sååledidh	såå^le^didh
såålhtestidh	såålh^tes^tidh
såångedidh	såå^nge^didh
sååresjidh	såå^re^sjidh
såårredidh	såår^re^didh
sægkoehtidh	sæg^koeh^tidh
sægkoelidh	sæg^koe^lidh
sæjkadidh	sæj^ka^didh
sæjladidh	sæj^la^didh
sæjlaridh	sæj^la^ridh
sæjloedidh	sæj^loe^didh
sæjloelidh	sæj^loe^lidh
sæjnadidh	sæj^na^didh
sæjngaridh	sæj^nga^ridh
sæjngegidh	sæj^nge^gidh
sæjnoedidh	sæj^noe^didh
sælloehtidh	sæl^loeh^tidh
sïbjegidh	sïb^je^gidh
sïejkedidh	sïej^ke^didh
sïejkenidh	sïej^ke^nidh
sïejvelidh	sïej^ve^lidh
sïekestidh	sïe^kes^tidh
sïektedidh	sïek^te^didh
sïekteridh	sïek^te^ridh
sïengkeldidh	sïeng^kel^didh
sïepestidh	sïe^pes^tidh
sïerredidh	sïer^re^didh
sïesseldidh	sïes^sel^didh
sïevehtidh	sïe^veh^tidh
sïevelidh	sïe^ve^lidh
sïevestidh	sïe^ves^tidh
sïhkesjidh	sïh^ke^sjidh
sïhtjegidh	sïh^tje^gidh
sïjhtjegidh	sïjht^je^gidh
sïjngegidh	sïj^nge^gidh
sïlledidh	sïl^le^didh
sïllestidh	sïl^les^tidh
sïlnehtidh	sïl^neh^tidh
sïmmedidh	sïm^me^didh
sööjnestidh	sööj^nes^tidh
söölkehtidh	sööl^keh^tidh
söölkestidh	sööl^kes^tidh
tiemsiestidh	tiem^sies^tidh
tjaabrestidh	tjaab^res^tidh
tjaagredidh	tjaag^re^didh
tjaahpasjidh	tjaah^pa^sjidh
tjaajanidh	tjaa^ja^nidh
tjaakanidh	tjaa^ka^nidh
tjaaksanidh	tjaak^sa^nidh
tjaalehtjidh	tjaa^leh^tjidh
tjaalestidh	tjaa^les^tidh
tjaangedidh	tjaa^nge^didh
tjaangelidh	tjaa^nge^lidh
tjaangeridh	tjaa^nge^ridh
tjaangestidh	tjaa^nges^tidh
tjaapasjidh	tjaa^pa^sjidh
tjaaptjesidh	tjaap^tje^sidh
tjaarhvehtidh	tjaarh^veh^tidh
tjaasmasjidh	tjaas^ma^sjidh
tjaasnasjidh	tjaas^na^sjidh
tjaatsestidh	tjaa^tses^tidh
tjaavhkestidh	tjaavh^kes^tidh
tjaavtsestidh	tjaav^tses^tidh
tjabrehtidh	tjab^reh^tidh
tjadmedidh	tjad^me^didh
tjaeliehtidh	tjae^lieh^tidh
tjaelielidh	tjae^lie^lidh
tjaeliestidh	tjae^lies^tidh
tjaesjmierdidh	tjaesj^mier^didh
tjaesmiestidh	tjaes^mies^tidh
tjaesniestidh	tjaes^nies^tidh
tjaetsiedidh	tjae^tsie^didh
tjaevtiestidh	tjaev^ties^tidh
tjagkedidh	tjag^ke^didh
tjahkanidh	tjah^ka^nidh
tjahkasjidh	tjah^ka^sjidh
tjahkeldidh	tjah^kel^didh
tjajmedidh	tjaj^me^didh
tjajnehtidh	tjaj^neh^tidh
tjalhkesjidh	tjalh^ke^sjidh
tjalkedidh	tjal^ke^didh
tjalkeridh	tjal^ke^ridh
tjallehtidh	tjal^leh^tidh
tjalmahtidh	tjal^mah^tidh
tjalmoestidh	tjal^moes^tidh
tjamkedidh	tjam^ke^didh
tjammadidh	tjam^ma^didh
tjammestidh	tjam^mes^tidh
tjanghkestidh	tjangh^kes^tidh
tjanhkestidh	tjanh^kes^tidh
tjanhtasjidh	tjanh^ta^sjidh
tjarkadidh	tjar^ka^didh
tjarmedidh	tjar^me^didh
tjarmelidh	tjar^me^lidh
tjarmenidh	tjar^me^nidh
tjarmeridh	tjar^me^ridh
tjarmestidh	tjar^mes^tidh
tjarnedidh	tjar^ne^didh
tjaskanidh	tjas^ka^nidh
tjaskelidh	tjas^ke^lidh
tjatnestidh	tjat^nes^tidh
tjavvadidh	tjav^va^didh
tjavvalidh	tjav^va^lidh
tjeahkehtidh	tjeah^keh^tidh
tjeakngasjidh	tjeak^nga^sjidh
tjeanadidh	tjea^na^didh
tjearadidh	tjea^ra^didh
tjearahtidh	tjea^rah^tidh
tjearoehtidh	tjea^roeh^tidh
tjearoestidh	tjea^roes^tidh
tjearvanidh	tjear^va^nidh
tjeavadidh	tjea^va^didh
tjeavhladidh	tjeavh^la^didh
tjeebrestidh	tjeeb^res^tidh
tjeejehtidh	tjee^jeh^tidh
tjeekedidh	tjee^ke^didh
tjeekehtidh	tjee^keh^tidh
tjeekngedidh	tjeek^nge^didh
tjeetnedidh	tjeet^ne^didh
tjehkierdidh	tjeh^kier^didh
tjehtjiedidh	tjeh^tjie^didh
tjekngiehtidh	tjek^ngieh^tidh
tjektjielidh	tjek^tjie^lidh
tjelhkiehtidh	tjelh^kieh^tidh
tjelkiehtidh	tjel^kieh^tidh
tjelmiehtidh	tjel^mieh^tidh
tjemkiedidh	tjem^kie^didh
tjeskierdidh	tjes^kier^didh
tjetskielidh	tjets^kie^lidh
tjevhtjiedidh	tjevht^jie^didh
tjevtjiehtidh	tjev^tjieh^tidh
tjevtjiestidh	tjev^tjies^tidh
tjevtsiestidh	tjev^tsies^tidh
tjibkestidh	tjib^kes^tidh
tjiehpiedidh	tjieh^pie^didh
tjietskesjidh	tjiets^ke^sjidh
tjietskielidh	tjiets^kie^lidh
tjievliedidh	tjiev^lie^didh
tjievriedidh	tjiev^rie^didh
tjihkedidh	tjih^ke^didh
tjihkehtidh	tjih^keh^tidh
tjihkenidh	tjih^ke^nidh
tjihkesidh	tjih^ke^sidh
tjihkestidh	tjih^kes^tidh
tjihkienidh	tjih^kie^nidh
tjihtedidh	tjih^te^didh
tjihtesjidh	tjih^te^sjidh
tjijriehtidh	tjij^rieh^tidh
tjilliestidh	tjil^lies^tidh
tjimhpierdidh	tjimh^pier^didh
tjimkehtidh	tjim^keh^tidh
tjimkestidh	tjim^kes^tidh
tjimperdidh	tjim^per^didh
tjipkiehtidh	tjip^kieh^tidh
tjirmestidh	tjir^mes^tidh
tjirrehtidh	tjir^reh^tidh
tjiskelidh	tjis^ke^lidh
tjiskesjidh	tjis^ke^sjidh
tjoedtjestidh	tjoed^tjes^tidh
tjoehpedidh	tjoeh^pe^didh
tjoehpestidh	tjoeh^pes^tidh
tjoejehtidh	tjoe^jeh^tidh
tjoejhkestidh	tjoejh^kes^tidh
tjoejkedidh	tjoej^ke^didh
tjoejkehtidh	tjoej^keh^tidh
tjoejkelidh	tjoej^ke^lidh
tjoejkestidh	tjoej^kes^tidh
tjoejkijidh	tjoej^ki^jidh
tjoekedidh	tjoe^ke^didh
tjoekehtidh	tjoe^keh^tidh
tjoelestidh	tjoe^les^tidh
tjoelmedidh	tjoel^me^didh
tjoelmelidh	tjoel^me^lidh
tjoelmenidh	tjoel^me^nidh
tjoelmeridh	tjoel^me^ridh
tjoelmesidh	tjoel^me^sidh
tjoelmestidh	tjoel^mes^tidh
tjoeltehtjidh	tjoel^teh^tjidh
tjoeltestidh	tjoel^tes^tidh
tjoemehtidh	tjoe^meh^tidh
tjoemestidh	tjoe^mes^tidh
tjoenedidh	tjoe^ne^didh
tjoeperdidh	tjoe^per^didh
tjoermehtidh	tjoer^meh^tidh
tjoetsestidh	tjoe^tses^tidh
tjoeveridh	tjoe^ve^ridh
tjoevkedidh	tjoev^ke^didh
tjoevkesjidh	tjoev^ke^sjidh
tjoevkestidh	tjoev^kes^tidh
tjoevkijidh	tjoev^ki^jidh
tjoevtestidh	tjoev^tes^tidh
tjogkeldidh	tjog^kel^didh
tjogledidh	tjog^le^didh
tjoglegidh	tjog^le^gidh
tjohkijidh	tjoh^ki^jidh
tjokngesjidh	tjok^nge^sjidh
tjoktjesjidh	tjok^tje^sjidh
tjolhkesjidh	tjolh^ke^sjidh
tjolhkestidh	tjolh^kes^tidh
tjolhtegidh	tjolh^te^gidh
tjolhterdidh	tjolh^ter^didh
tjolhtsestidh	tjolht^ses^tidh
tjolkehtidh	tjol^keh^tidh
tjolledidh	tjol^le^didh
tjomberdidh	tjom^ber^didh
tjomperdidh	tjom^per^didh
tjonnestidh	tjon^nes^tidh
tjopkenidh	tjop^ke^nidh
tjopkesidh	tjop^ke^sidh
tjoptedidh	tjop^te^didh
tjorhkehtidh	tjorh^keh^tidh
tjorhkesjidh	tjorh^ke^sjidh
tjorkedidh	tjor^ke^didh
tjorkehtidh	tjor^keh^tidh
tjorregidh	tjor^re^gidh
tjoskehtidh	tjos^keh^tidh
tjovnedidh	tjov^ne^didh
tjovrestidh	tjov^res^tidh
tjuatsajidh	tjua^tsa^jidh
tjuedtjielidh	tjued^tjie^lidh
tjuengieldidh	tjue^ngiel^didh
tjuetsielidh	tjue^tsie^lidh
tjuetsiestidh	tjue^tsies^tidh
tjugkiestidh	tjug^kies^tidh
tjulhkiehtidh	tjulh^kieh^tidh
tjulkedidh	tjul^ke^didh
tjulkiehtidh	tjul^kieh^tidh
tjultjiedidh	tjul^tjie^didh
tjummiestidh	tjum^mies^tidh
tjunghkierdidh	tjungh^kier^didh
tjuvliestidh	tjuv^lies^tidh
tjuvtjiedidh	tjuv^tjie^didh
tjuvviestidh	tjuv^vies^tidh
tjyhskehtidh	tjyh^skeh^tidh
tjyskehtidh	tjys^keh^tidh
tjyöredidh	tjyö^re^didh
tjyörijidh	tjyö^ri^jidh
tjyöskehtidh	tjyös^keh^tidh
tjåadtjahtidh	tjåad^tjah^tidh
tjåadtjoehtidh	tjåad^tjoeh^tidh
tjåadtjoestidh	tjåad^tjoes^tidh
tjåagkahtidh	tjåag^kah^tidh
tjåagkalidh	tjåag^ka^lidh
tjåagkastidh	tjåag^kas^tidh
tjåagkestidh	tjåag^kes^tidh
tjåalagidh	tjåa^la^gidh
tjåalastidh	tjåa^las^tidh
tjåaloestidh	tjåa^loes^tidh
tjåanghkenidh	tjåangh^ke^nidh
tjåatskoedidh	tjåats^koe^didh
tjåegkiehtidh	tjåeg^kieh^tidh
tjåektjiehtidh	tjåek^tjieh^tidh
tjåenghkierdidh	tjåengh^kier^didh
tjåetskiedidh	tjåets^kie^didh
tjåetskiedidh	tjåets^kie^didh
tjålhtasjidh	tjålh^ta^sjidh
tjånnahtidh	tjån^nah^tidh
tjåvhtjadidh	tjåvht^ja^didh
tjåvradidh	tjåv^ra^didh
tjåvvadidh	tjåv^va^didh
tjåådedidh	tjåå^de^didh
tjåådesjidh	tjåå^de^sjidh
tjåådtjehtidh	tjååd^tjeh^tidh
tjååhpedidh	tjååh^pe^didh
tjååhpenidh	tjååh^pe^nidh
tjåålhkesjidh	tjåålh^ke^sjidh
tjåålkesjidh	tjåål^ke^sjidh
tjåålledidh	tjåål^le^didh
tjååltjestidh	tjåål^tjes^tidh
tjåånehtidh	tjåå^neh^tidh
tjååredidh	tjåå^re^didh
tjååresjidh	tjåå^re^sjidh
tjåårijidh	tjåå^ri^jidh
tjååvkedidh	tjååv^ke^didh
tjælloestidh	tjæl^loes^tidh
tjïeglehtidh	tjïeg^leh^tidh
tjïeglesidh	tjïeg^le^sidh
tjïehkeldidh	tjïeh^kel^didh
tjïehkerdidh	tjïeh^ker^didh
tjïekedidh	tjïe^ke^didh
tjïekelidh	tjïe^ke^lidh
tjïekerdidh	tjïe^ker^didh
tjïektjedidh	tjïek^tje^didh
tjïektjelidh	tjïek^tje^lidh
tjïektjestidh	tjïek^tjes^tidh
tjïelkedidh	tjïel^ke^didh
tjïelkenidh	tjïel^ke^nidh
tjïelkesidh	tjïel^ke^sidh
tjïelkestidh	tjïel^kes^tidh
tjïellegidh	tjïel^le^gidh
tjïerestidh	tjïe^res^tidh
tjïertestidh	tjïer^tes^tidh
tjïervenidh	tjïer^ve^nidh
tjïeskehtidh	tjïes^keh^tidh
tjïeskelidh	tjïes^ke^lidh
tjïeskestidh	tjïes^kes^tidh
tjïevkenidh	tjïev^ke^nidh
tjïevledidh	tjïev^le^didh
tjïevlestidh	tjïev^les^tidh
tjïktedidh	tjïk^te^didh
tjïlterdidh	tjïl^ter^didh
tjïpkesidh	tjïp^ke^sidh
tjïrredidh	tjïr^re^didh
tjïrrehtidh	tjïr^reh^tidh
tjïskehtidh	tjïs^keh^tidh
tjïskelidh	tjïs^ke^lidh
tjïskesidh	tjïs^ke^sidh
tjïvkedidh	tjïv^ke^didh
tjöödtjehtidh	tjööd^tjeh^tidh
tjöödtjestidh	tjööd^tjes^tidh
tjöönghkedidh	tjööngh^ke^didh
tjöönghkelidh	tjööngh^ke^lidh
tjöörvestidh	tjöör^ves^tidh
toelhkestidh	toelh^kes^tidh
toeverdidh	toe^ver^didh
toffeldidh	tof^fel^didh
toffestidh	tof^fes^tidh
tompeldidh	tom^pel^didh
traagkanidh	traag^ka^nidh
traakestidh	traa^kes^tidh
trabkelidh	trab^ke^lidh
traegkiedidh	traeg^kie^didh
tramhkahtidh	tramh^kah^tidh
tramhkelidh	tramh^ke^lidh
tramhkesjidh	tramh^ke^sjidh
tramhkoehtidh	tramh^koeh^tidh
trapkesidh	trap^ke^sidh
traskesjidh	tras^ke^sjidh
treangkestidh	treang^kes^tidh
treapasidh	trea^pa^sidh
treekeldidh	tree^kel^didh
treemhpestidh	treemh^pes^tidh
trepkiehtidh	trep^kieh^tidh
triepkiehtidh	triep^kieh^tidh
trimhkestidh	trimh^kes^tidh
triskiehtidh	tris^kieh^tidh
triskiestidh	tris^kies^tidh
tromsegidh	trom^se^gidh
tropkesidh	trop^ke^sidh
trumhpiestidh	trumh^pies^tidh
truvkiedidh	truv^kie^didh
truvkiemdidh	truv^kiem^didh
tryöjjadidh	tryöj^ja^didh
tråepkiehtidh	tråep^kieh^tidh
tråjjadidh	tråj^ja^didh
træjjadidh	træj^ja^didh
trïengkestidh	trïeng^kes^tidh
trïepkelidh	trïep^ke^lidh
trïjsedidh	trïj^se^didh
trïskedidh	trïs^ke^didh
tröörehtidh	tröö^reh^tidh
tsaapedidh	tsaa^pe^didh
tsaapelidh	tsaa^pe^lidh
tsaekiehtidh	tsae^kieh^tidh
tsaekielidh	tsae^kie^lidh
tsaepmiehtidh	tsaep^mieh^tidh
tsaepmiestidh	tsaep^mies^tidh
tsagkehtidh	tsag^keh^tidh
tsagkelidh	tsag^ke^lidh
tsagkesidh	tsag^ke^sidh
tsagkestidh	tsag^kes^tidh
tsamkoehtidh	tsam^koeh^tidh
tsamtsestidh	tsam^tses^tidh
tsapkelidh	tsap^ke^lidh
tsaptsenidh	tsap^tse^nidh
tsavvalidh	tsav^va^lidh
tseagkanidh	tseag^ka^nidh
tseagkasjidh	tseag^ka^sjidh
tseahkestidh	tseah^kes^tidh
tseahkoedidh	tseah^koe^didh
tseaktselidh	tseak^tse^lidh
tsealhkahtidh	tsealh^kah^tidh
tsebpeldidh	tseb^pel^didh
tsebpieldidh	tseb^piel^didh
tseegkestidh	tseeg^kes^tidh
tseelhkestidh	tseelh^kes^tidh
tsegniehtidh	tseg^nieh^tidh
tsenhkiehtidh	tsenh^kieh^tidh
tsepkiehtidh	tsep^kieh^tidh
tsevtsiehtidh	tsev^tsieh^tidh
tsevtsiestidh	tsev^tsies^tidh
tsibpeldidh	tsib^pel^didh
tsihkesjidh	tsih^ke^sjidh
tsimtsedidh	tsim^tse^didh
tsimtsiedidh	tsim^tsie^didh
tsipkiehtidh	tsip^kieh^tidh
tsiptsegidh	tsip^tse^gidh
tsiptsehtjidh	tsip^tseh^tjidh
tsiptsielidh	tsip^tsie^lidh
tsiptsiestidh	tsip^tsies^tidh
tsirkiestidh	tsir^kies^tidh
tsivtsiedidh	tsiv^tsie^didh
tsoedtsesjidh	tsoed^tse^sjidh
tsoedtsestidh	tsoed^tses^tidh
tsoepkenidh	tsoep^ke^nidh
tsollijidh	tsol^li^jidh
tsomhtsegidh	tsomht^se^gidh
tsopkesidh	tsop^ke^sidh
tsumhtsiestidh	tsumht^sies^tidh
tsunkesidh	tsun^ke^sidh
tsunkiehtidh	tsun^kieh^tidh
tsupkiehtidh	tsup^kieh^tidh
tsutskestidh	tsuts^kes^tidh
tsuvvielidh	tsuv^vie^lidh
tsygkedidh	tsyg^ke^didh
tsyllijidh	tsyl^li^jidh
tsyögkegidh	tsyög^ke^gidh
tsyögkesidh	tsyög^ke^sidh
tsåajkoehtidh	tsåaj^koeh^tidh
tsåalhkelidh	tsåalh^ke^lidh
tsåalhkesjidh	tsåalh^ke^sjidh
tsåalhkoehtidh	tsåalh^koeh^tidh
tsåehkiehtidh	tsåeh^kieh^tidh
tsåehkiestidh	tsåeh^kies^tidh
tsåektjiehtidh	tsåek^tjieh^tidh
tsåektsiehtidh	tsåek^tsieh^tidh
tsåelhkiestidh	tsåelh^kies^tidh
tsåetskiehtidh	tsåets^kieh^tidh
tsåvvalidh	tsåv^va^lidh
tsåålhkesidh	tsåålh^ke^sidh
tsåålkesjidh	tsåål^ke^sjidh
tsæhtsasjidh	tsæh^tsa^sjidh
tsælloehtidh	tsæl^loeh^tidh
tsïegkenidh	tsïeg^ke^nidh
tsïeglesjidh	tsïeg^le^sjidh
tsïehkehtidh	tsïeh^keh^tidh
tsïehkestidh	tsïeh^kes^tidh
tsïengeldidh	tsïe^ngel^didh
tsïeskelidh	tsïes^ke^lidh
tsïetskelidh	tsïets^ke^lidh
tsïevhkehtidh	tsïevh^keh^tidh
tsïhkijidh	tsïh^ki^jidh
tsïpkesidh	tsïp^ke^sidh
tsïptsehtjidh	tsïp^tseh^tjidh
tsïptselidh	tsïp^tse^lidh
tsöögkegidh	tsöög^ke^gidh
tsööpkestidh	tsööp^kes^tidh
tuarvadidh	tuar^va^didh
tunsehtidh	tun^seh^tidh
työvedidh	työ^ve^didh
työvestidh	työ^ves^tidh
tåavoehtidh	tåa^voeh^tidh
tïmperdidh	tïm^per^didh
tööredidh	töö^re^didh
uhtjiedidh	uh^tjie^didh
uhtjiemdidh	uh^tjiem^didh
uhtjiestidh	uh^tjies^tidh
ujkierdidh	uj^kier^didh
unniedidh	un^nie^didh
urkiedidh	ur^kie^didh
ussjedidh	us^sje^didh
ussjiedidh	us^sjie^didh
utniedidh	ut^nie^didh
utniehtidh	ut^nieh^tidh
utniestidh	ut^nies^tidh
uvtedidh	uv^te^didh
vaadtsajidh	vaad^tsa^jidh
vaadtsehtjidh	vaad^tseh^tjidh
vaajaldidh	vaa^jal^didh
vaajestidh	vaa^jes^tidh
vaajjeldidh	vaaj^jel^didh
vaajmehtidh	vaaj^meh^tidh
vaajnoedidh	vaaj^noe^didh
vaajpanidh	vaaj^pa^nidh
vaajtelidh	vaaj^te^lidh
vaajvenidh	vaaj^ve^nidh
vaakoedidh	vaa^koe^didh
vaaksjoehtidh	vaak^sjoeh^tidh
vaaksjoestidh	vaak^sjoes^tidh
vaaktedidh	vaak^te^didh
vaaledidh	vaa^le^didh
vaaljesjidh	vaa^lje^sjidh
vaalmerdidh	vaal^mer^didh
vaalmestidh	vaal^mes^tidh
vaanamidh	vaa^na^midh
vaananidh	vaa^na^nidh
vaanterdidh	vaan^ter^didh
vaapandidh	vaa^pan^didh
vaapeldidh	vaa^pel^didh
vaapesjidh	vaa^pe^sjidh
vaarjasjidh	vaar^ja^sjidh
vaarjedidh	vaar^je^didh
vaarjelidh	vaar^je^lidh
vaarnahtidh	vaar^nah^tidh
vaaroehtidh	vaa^roeh^tidh
vaarredidh	vaar^re^didh
vaarrelidh	vaar^re^lidh
vaarrestidh	vaar^res^tidh
vaartasjidh	vaar^ta^sjidh
vaatnoehtidh	vaat^noeh^tidh
vaaverdidh	vaa^ver^didh
vadtedidh	vad^te^didh
vaedtsiehtidh	vaed^tsieh^tidh
vaedtsielidh	vaed^tsie^lidh
vaedtsiestidh	vaed^tsies^tidh
vaejviedidh	vaej^vie^didh
vaejviestidh	vaej^vies^tidh
vaelmiehtidh	vael^mieh^tidh
vaelmierdidh	vael^mier^didh
vaeniedidh	vae^nie^didh
vaeniedidh	vae^nie^didh
vaeptiestidh	vaep^ties^tidh
vaerhpiedidh	vaerh^pie^didh
vaeriedidh	vae^rie^didh
vaesiehtidh	vae^sieh^tidh
vaesiestidh	vae^sies^tidh
vaestiedidh	vaes^tie^didh
vaestiehtidh	vaes^tieh^tidh
vaesviestidh	vaes^vies^tidh
vaetiestidh	vae^ties^tidh
vajmehtidh	vaj^meh^tidh
vajmeldidh	vaj^mel^didh
vajmestidh	vaj^mes^tidh
valkesidh	val^ke^sidh
varhtodidh	varh^to^didh
varhtoedidh	varh^toe^didh
vartajidh	var^ta^jidh
vastasjidh	vas^ta^sjidh
veadtaskidh	vead^tas^kidh
veadtestidh	vead^tes^tidh
veahkaridh	veah^ka^ridh
veahkasidh	veah^ka^sidh
veajahtidh	vea^jah^tidh
veajalidh	vea^ja^lidh
veajhtastidh	veajh^tas^tidh
veajhtoestidh	veajh^toes^tidh
vealasjidh	vea^la^sjidh
vealhtjaridh	vealht^ja^ridh
vealkasjidh	veal^ka^sjidh
veangasjidh	vea^nga^sjidh
veanhtadidh	veanh^ta^didh
veanoehtidh	vea^noeh^tidh
vearadidh	vea^ra^didh
vearedidh	vea^re^didh
vearestidh	vea^res^tidh
vearranidh	vear^ra^nidh
veartasjidh	vear^ta^sjidh
veasastidh	vea^sas^tidh
veasoestidh	vea^soes^tidh
vedtielidh	ved^tie^lidh
vedtiestidh	ved^ties^tidh
veejhtehtidh	veejh^teh^tidh
veekseldidh	veek^sel^didh
veeledidh	vee^le^didh
veelestidh	vee^les^tidh
veeljedidh	vee^lje^didh
veerkehtidh	veer^keh^tidh
vejtiestidh	vej^ties^tidh
velkiehtidh	vel^kieh^tidh
verkiestidh	ver^kies^tidh
verviestidh	ver^vies^tidh
viedtielidh	vied^tie^lidh
viehkiehtidh	vieh^kieh^tidh
viejiehtidh	vie^jieh^tidh
vielhterdidh	vielh^ter^didh
vielkiedidh	viel^kie^didh
vielkiestidh	viel^kies^tidh
vienjiedidh	vie^njie^didh
vierhkiedidh	vierh^kie^didh
vierhtiedidh	vierh^tie^didh
vierkedidh	vier^ke^didh
vierkiedidh	vier^kie^didh
vierriedidh	vier^rie^didh
vierriedidh	vier^rie^didh
viertiestidh	vier^ties^tidh
viesjiehtidh	vie^sjieh^tidh
viesjliedidh	viesj^lie^didh
vievliedidh	viev^lie^didh
vihtiestidh	vih^ties^tidh
vihtsieldidh	vih^tsiel^didh
vijhtjerdidh	vijht^jer^didh
vijhtserdidh	vijht^ser^didh
vijhtsieldidh	vijht^siel^didh
vijhtsierdidh	vijht^sier^didh
vijhtsiestidh	vijht^sies^tidh
vijniedidh	vij^nie^didh
vijnierdidh	vij^nier^didh
vijriedidh	vij^rie^didh
vijriedidh	vij^rie^didh
vijriedidh	vij^rie^didh
vijtjeldidh	vij^tjel^didh
vikseldidh	vik^sel^didh
villiedidh	vil^lie^didh
vilnjegidh	vil^nje^gidh
vilnjehtidh	vil^njeh^tidh
vilnjestidh	vil^njes^tidh
vilnjiehtidh	vil^njieh^tidh
virhkiedidh	virh^kie^didh
virtiehtidh	vir^tieh^tidh
voebnesjidh	voeb^ne^sjidh
voegkestidh	voeg^kes^tidh
voejedidh	voe^je^didh
voejehtidh	voe^jeh^tidh
voejehtjidh	voe^jeh^tjidh
voejelidh	voe^je^lidh
voejestidh	voe^jes^tidh
voejhkelidh	voejh^ke^lidh
voejijidh	voe^ji^jidh
voejnesidh	voej^ne^sidh
voejngehtidh	voej^ngeh^tidh
voejngestidh	voej^nges^tidh
voekesjidh	voe^ke^sjidh
voeksedidh	voek^se^didh
voeledidh	voe^le^didh
voelkedidh	voel^ke^didh
voelkehtidh	voel^keh^tidh
voelkesjidh	voel^ke^sjidh
voelmesidh	voel^me^sidh
voelmestidh	voel^mes^tidh
voelpesjidh	voel^pe^sjidh
voemsehtidh	voem^seh^tidh
voengestidh	voe^nges^tidh
voepedidh	voe^pe^didh
voepsestidh	voep^ses^tidh
voeredidh	voe^re^didh
voerehtidh	voe^reh^tidh
voerenidh	voe^re^nidh
voerhkedidh	voerh^ke^didh
voerkehtidh	voer^keh^tidh
voerkelidh	voer^ke^lidh
voerkesidh	voer^ke^sidh
voervelidh	voer^ve^lidh
voessjehtidh	voes^sjeh^tidh
voessjehtjidh	voes^sjeh^tjidh
voessjelidh	voes^sje^lidh
voessjestidh	voes^sjes^tidh
voetjedidh	voe^tje^didh
voetjehtjidh	voe^tjeh^tjidh
voetjelidh	voe^tje^lidh
voetjerdidh	voe^tjer^didh
voetjeridh	voe^tje^ridh
voetkedidh	voet^ke^didh
voevjehtjidh	voev^jeh^tjidh
voevjelidh	voev^je^lidh
volveridh	vol^ve^ridh
vuajajidh	vua^ja^jidh
vuajnajidh	vuaj^na^jidh
vualamidh	vua^la^midh
vualanidh	vua^la^nidh
vualkajidh	vual^ka^jidh
vuaralidh	vua^ra^lidh
vuarjasjidh	vuar^ja^sjidh
vuartajidh	vuar^ta^jidh
vuartasjidh	vuar^ta^sjidh
vuastalidh	vuas^ta^lidh
vuavkesjidh	vuav^ke^sjidh
vuavtasjidh	vuav^ta^sjidh
vuejiehtidh	vue^jieh^tidh
vuejielidh	vue^jie^lidh
vuejniestidh	vuej^nies^tidh
vueliedidh	vue^lie^didh
vueliemdidh	vue^liem^didh
vuelkielidh	vuel^kie^lidh
vuemsiehtidh	vuem^sieh^tidh
vuemsiestidh	vuem^sies^tidh
vuenjiedidh	vue^njie^didh
vuepsiehtidh	vuep^sieh^tidh
vueptiestidh	vuep^ties^tidh
vuerhkielidh	vuerh^kie^lidh
vueriedidh	vue^rie^didh
vuerkiehtidh	vuer^kieh^tidh
vuertiehtidh	vuer^tieh^tidh
vuertiestidh	vuer^ties^tidh
vuesiehtidh	vue^sieh^tidh
vuesviestidh	vues^vies^tidh
vuetjiedidh	vue^tjie^didh
vuetjieridh	vue^tjie^ridh
vyjhpelidh	vyjh^pe^lidh
vyskedidh	vys^ke^didh
vytnesjidh	vyt^ne^sjidh
vyvnelidh	vyv^ne^lidh
vyöhkesidh	vyöh^ke^sidh
vyölkedidh	vyöl^ke^didh
vyölkenidh	vyöl^ke^nidh
vyösijidh	vyö^si^jidh
våajahtidh	våa^jah^tidh
våajaldidh	våa^jal^didh
våajalidh	våa^ja^lidh
våajoedidh	våa^joe^didh
våajoehtidh	våa^joeh^tidh
våajoelidh	våa^joe^lidh
våamsoehtidh	våam^soeh^tidh
våarnahtidh	våar^nah^tidh
våarnoehtidh	våar^noeh^tidh
våarpoehtidh	våar^poeh^tidh
våatjasidh	våa^tja^sidh
våavkasjidh	våav^ka^sjidh
våavtsoestidh	våav^tsoes^tidh
vååjmestidh	vååj^mes^tidh
vååjnedidh	vååj^ne^didh
vååjneridh	vååj^ne^ridh
vååksjedidh	vååk^sje^didh
våårhkedidh	våårh^ke^didh
våårkedidh	våår^ke^didh
vååtjedidh	våå^tje^didh
vååtjeridh	våå^tje^ridh
vååvkesjidh	vååv^ke^sjidh
væhnadidh	væh^na^didh
væhtnadidh	væht^na^didh
væjkadidh	væj^ka^didh
væjramidh	væj^ra^midh
væjranidh	væj^ra^nidh
væjraskidh	væj^ras^kidh
væntjastidh	væn^tjas^tidh
værhtoedidh	værh^toe^didh
værradidh	vær^ra^didh
væspadidh	væs^pa^didh
væssjoehtidh	væs^sjoeh^tidh
vïbpeldidh	vïb^pel^didh
vïdtjeldidh	vïd^tjel^didh
vïdtjerdidh	vïd^tjer^didh
vïedteldidh	vïed^tel^didh
vïedtelidh	vïed^te^lidh
vïedtestidh	vïed^tes^tidh
vïegkedidh	vïeg^ke^didh
vïegkehtidh	vïeg^keh^tidh
vïeglesjidh	vïeg^le^sjidh
vïehkesjidh	vïeh^ke^sjidh
vïehkiesjidh	vïeh^kie^sjidh
vïejsehtidh	vïej^seh^tidh
vïekedidh	vïe^ke^didh
vïekesjidh	vïe^ke^sjidh
vïelhterdidh	vïelh^ter^didh
vïelkehtidh	vïel^keh^tidh
vïelkesidh	vïel^ke^sidh
vïengerdidh	vïe^nger^didh
vïengkerdidh	vïeng^ker^didh
vïenhtestidh	vïenh^tes^tidh
vïeredidh	vïe^re^didh
vïereridh	vïe^re^ridh
vïerestidh	vïe^res^tidh
vïerhvesjidh	vïerh^ve^sjidh
vïerkedidh	vïer^ke^didh
vïesedidh	vïe^se^didh
vïesehtidh	vïe^seh^tidh
vïetjeldidh	vïe^tjel^didh
vïevtjedidh	vïev^tje^didh
vïgkehtidh	vïg^keh^tidh
vïhnesjidh	vïh^ne^sjidh
vïhnestidh	vïh^nes^tidh
vïhtesjidh	vïh^te^sjidh
vïjhtesjidh	vïjh^te^sjidh
vïjjedidh	vïj^je^didh
vïjjestidh	vïj^jes^tidh
vïjkesjidh	vïj^ke^sjidh
vïjlehtidh	vïj^leh^tidh
vïjlelidh	vïj^le^lidh
vïlhkestidh	vïlh^kes^tidh
vïlledidh	vïl^le^didh
vïllestidh	vïl^les^tidh
vïntserdidh	vïn^tser^didh
vïsperdidh	vïs^per^didh
vïtnedidh	vït^ne^didh
vïtnehtidh	vït^neh^tidh
vïtnelidh	vït^ne^lidh
vïtnesjidh	vït^ne^sjidh
vïtnjedidh	vït^nje^didh
vöörhkelidh	vöörh^ke^lidh
yörhkedidh	yörh^ke^didh
åadajidh	åa^da^jidh
åadtjelidh	åad^tje^lidh
åadtjestidh	åad^tjes^tidh
åahpenidh	åah^pe^nidh
åajaldidh	åa^jal^didh
åajkasidh	åaj^ka^sidh
åajmeskidh	åaj^mes^kidh
åajvadidh	åaj^va^didh
åajvahtidh	åaj^vah^tidh
åajvedidh	åaj^ve^didh
åaksesjidh	åak^se^sjidh
åalhtaridh	åalh^ta^ridh
åamaskidh	åa^mas^kidh
åamastidh	åa^mas^tidh
åanamidh	åa^na^midh
åananidh	åa^na^nidh
åanhtoehtidh	åanh^toeh^tidh
åantoehtidh	åan^toeh^tidh
åarajidh	åa^ra^jidh
åarehtjidh	åa^reh^tjidh
åarkestidh	åar^kes^tidh
åastehtjidh	åas^teh^tjidh
åavroestidh	åav^roes^tidh
åeliedidh	åe^lie^didh
åelkiestidh	åel^kies^tidh
åemiedidh	åe^mie^didh
åeniedidh	åe^nie^didh
åeniemdidh	åe^niem^didh
åeriestidh	åe^ries^tidh
åesiestidh	åe^sies^tidh
åestiestidh	åes^ties^tidh
åevriedidh	åev^rie^didh
åhtjanidh	åh^tja^nidh
åhtjasjidh	åh^tja^sjidh
åjjeldidh	åj^jel^didh
ålkamidh	ål^ka^midh
ålkoestidh	ål^koes^tidh
ånnadidh	ån^na^didh
ånnanidh	ån^na^nidh
ånnasjidh	ån^na^sjidh
åsksesjidh	åsk^se^sjidh
åssjoelidh	ås^sjoe^lidh
åvtanidh	åv^ta^nidh
åvtenidh	åv^te^nidh
ååbredidh	ååb^re^didh
åådtjedidh	ååd^tje^didh
åågkesjidh	ååg^ke^sjidh
ååhpedidh	ååh^pe^didh
ååjmedidh	ååj^me^didh
åålestidh	åå^les^tidh
åålmestidh	åål^mes^tidh
ååltehtidh	åål^teh^tidh
åånedidh	åå^ne^didh
ååvredidh	ååv^re^didh
æjjalidh	æj^ja^lidh
ærmoedidh	ær^moe^didh
ïebnestidh	ïeb^nes^tidh
ïervijidh	ïer^vi^jidh
övtiedidh	öv^tie^didh
övtiedidh	öv^tie^didh
ööhpehtidh	ööh^peh^tidh
ööjjeldidh	ööj^jel^didh
öölegidh	öö^le^gidh
öörnedidh	öör^ne^didh
